Rank,Release Group,Worldwide,Domestic,Foreign,filename,year,Domestic %,Foreign %
1,Avengers: Endgame,2799439100,858373000,1941066100,2019.csv,2019,0.30662320891352846,0.6933767910864715
2,Avatar: The Way of Water,2320250281,684075767,1636174514,2022.csv,2022,0.2948284383808679,0.7051715616191321
3,Star Wars: Episode VII - The Force Awakens,2068223624,936662225,1131561399,2015.csv,2015,0.4528824707980417,0.5471175292019583
4,Avengers: Infinity War,2048359754,678815482,1369544272,2018.csv,2018,0.3313946589091205,0.6686053410908794
5,Spider-Man: No Way Home,1912233593,804793477,1107440116,2021.csv,2021,0.4208656724503009,0.5791343275496991
6,Jurassic World,1670400637,652270625,1018130012,2015.csv,2015,0.39048753368022093,0.6095124663197791
7,The Lion King,1656943394,543638043,1113305351,2019.csv,2019,0.32809693135479556,0.6719030686452044
8,Furious 7,1515047671,353007020,1162040651,2015.csv,2015,0.23300060239490641,0.7669993976050936
9,Top Gun: Maverick,1495696292,718732821,776963471,2022.csv,2022,0.48053393248634196,0.5194660675136581
10,Frozen II,1450026933,477373578,972653355,2019.csv,2019,0.329217042205105,0.6707829577948949
11,Avengers: Age of Ultron,1402805868,459005868,943800000,2015.csv,2015,0.3272055517235689,0.6727944482764311
12,The Super Mario Bros. Movie,1352756895,574173895,778583000,2023.csv,2023,0.42444721377672223,0.5755527862232778
13,Black Panther,1346913161,700059566,646853595,2018.csv,2018,0.5197510769589992,0.4802489230410007
14,Star Wars: Episode VIII - The Last Jedi,1332539889,620181382,712358507,2017.csv,2017,0.465412995978239,0.5345870040217611
15,Jurassic World: Fallen Kingdom,1308467944,417719760,890748184,2018.csv,2018,0.3192434036427567,0.6807565963572433
16,Frozen,1280802282,400738009,880064273,2013.csv,2013,0.31288046143565507,0.6871195385643449
17,Beauty and the Beast,1263521126,504014165,759506961,2017.csv,2017,0.3988965080430321,0.6011034919569679
18,Incredibles 2,1242805359,608581744,634223615,2018.csv,2018,0.48968387494698595,0.510316125053014
19,The Fate of the Furious,1236005118,226008385,1009996733,2017.csv,2017,0.1828539232634472,0.8171460767365528
20,Iron Man 3,1214811252,409013994,805797258,2013.csv,2013,0.33668933616363966,0.6633106638363603
21,Minions,1159398397,336045770,823352627,2015.csv,2015,0.28984494964762314,0.7101550503523768
22,Captain America: Civil War,1153296293,408084349,745211944,2016.csv,2016,0.35384172434862754,0.6461582756513724
23,Aquaman,1148461807,335061807,813400000,2018.csv,2018,0.2917483236776023,0.7082516763223977
24,The Lord of the Rings: The Return of the King,1140682011,377027325,763654686,2003.csv,2003,0.3305279835784138,0.6694720164215863
25,Spider-Man: Far from Home,1131927996,390532085,741395911,2019.csv,2019,0.345014953583673,0.654985046416327
26,Captain Marvel,1128274794,426829839,701444955,2019.csv,2019,0.3783030882811692,0.6216969117188308
27,Transformers: Age of Extinction,1104054072,245439076,858614996,2014.csv,2014,0.22230711540729683,0.7776928845927031
28,Joker,1074251311,335451311,738800000,2019.csv,2019,0.3122652097931673,0.6877347902068327
29,Star Wars: Episode IX - The Rise of Skywalker,1074144248,515202542,558941706,2019.csv,2019,0.4796399952420543,0.5203600047579457
30,Toy Story 4,1073394593,434038008,639356585,2019.csv,2019,0.4043601587249657,0.5956398412750342
31,Rogue One: A Star Wars Story,1056057273,532177324,523879949,2016.csv,2016,0.5039284682810948,0.49607153171890517
32,Aladdin,1050693953,355559216,695134737,2019.csv,2019,0.3384041708670612,0.6615958291329388
33,Despicable Me 3,1034799409,264624300,770175109,2017.csv,2017,0.2557252136969475,0.7442747863030524
34,Barbie,1031481000,459381000,572100000,2023.csv,2023,0.4453606028613227,0.5546393971386773
35,Finding Dory,1028570889,486295561,542275328,2016.csv,2016,0.47278759898871686,0.5272124010112832
36,Zootopia,1023784195,341268248,682515947,2016.csv,2016,0.3333400238709487,0.6666599761290513
37,Jurassic World Dominion,1001978080,376851080,625127000,2022.csv,2022,0.3761071100477567,0.6238928899522432
38,Harry Potter and the Sorcerer's Stone,974755371,317575550,657179821,2001.csv,2001,0.32580025660612644,0.6741997433938736
39,Despicable Me 2,970766005,368065385,602700620,2013.csv,2013,0.3791494377679614,0.6208505622320386
40,The Jungle Book,966550600,364001123,602549477,2016.csv,2016,0.3765981036067848,0.6234018963932152
41,Jumanji: Welcome to the Jungle,962077546,404515480,557562066,2017.csv,2017,0.42046036900231326,0.5795396309976868
42,The Hobbit: The Desolation of Smaug,958366855,258366855,700000000,2013.csv,2013,0.2695907664711547,0.7304092335288452
43,The Hobbit: The Battle of the Five Armies,956019788,255119788,700900000,2014.csv,2014,0.26685617934092387,0.7331438206590761
44,Doctor Strange in the Multiverse of Madness,955775804,411331607,544444197,2022.csv,2022,0.43036411392561263,0.5696358860743874
45,Minions: The Rise of Gru,939628210,369695210,569933000,2022.csv,2022,0.3934483938067377,0.6065516061932623
46,The Lord of the Rings: The Two Towers,936689735,339789881,596899854,2002.csv,2002,0.36275606351125433,0.6372439364887457
47,Shrek 2,928760770,441226247,487534523,2004.csv,2004,0.47506985787093486,0.5249301421290652
48,Bohemian Rhapsody,903655259,216428042,687227217,2018.csv,2018,0.23950288546929155,0.7604971145307085
49,The Battle at Lake Changjin,902548476,342411,902206065,2021.csv,2021,0.0003793823923093079,0.9996206176076907
50,Harry Potter and the Goblet of Fire,895921036,290013036,605908000,2005.csv,2005,0.3237037912345659,0.6762962087654341
51,The Lord of the Rings: The Fellowship of the Ring,880839846,313364114,567475732,2001.csv,2001,0.35575606101724877,0.6442439389827512
52,Spectre,880674609,200074609,680600000,2015.csv,2015,0.22718335121207064,0.7728166487879293
53,Spider-Man: Homecoming,880166924,334201140,545965784,2017.csv,2017,0.37970199843592395,0.620298001564076
54,Harry Potter and the Chamber of Secrets,878979634,261988482,616991152,2002.csv,2002,0.2980597864455185,0.7019402135544816
55,The Secret Life of Pets,875457937,368384330,507073607,2016.csv,2016,0.42079043941548044,0.5792095605845196
56,Batman v Superman: Dawn of Justice,873634919,330360194,543274725,2016.csv,2016,0.3781444477724682,0.6218555522275317
57,Finding Nemo,871014978,339714978,531300000,2003.csv,2003,0.3900219704373442,0.6099780295626558
58,Wolf Warrior 2,870325439,2721100,867604339,2017.csv,2017,0.003126531614572282,0.9968734683854277
59,Star Wars: Episode III - Revenge of the Sith,868352530,380270577,488081953,2005.csv,2005,0.437921885250913,0.562078114749087
60,The Hunger Games: Catching Fire,865011746,424668047,440343699,2013.csv,2013,0.490939052520103,0.5090609474798969
61,Guardians of the Galaxy Vol. 2,863756051,389813101,473942950,2017.csv,2017,0.4512999944240043,0.5487000055759956
62,Black Panther: Wakanda Forever,859208836,453829060,405379776,2022.csv,2022,0.5281941257875984,0.4718058742124016
63,Inside Out,857611174,356461711,501149463,2015.csv,2015,0.4156449004009829,0.5843550995990171
64,Venom,856085151,213515506,642569645,2018.csv,2018,0.24940919224050412,0.7505908077594958
65,Thor: Ragnarok,853977126,315058289,538918837,2017.csv,2017,0.36893059475225337,0.6310694052477467
66,Guardians of the Galaxy Vol. 3,845332006,358991799,486340207,2023.csv,2023,0.42467550790925573,0.5753244920907443
67,"Hi, Mom",822009764,0,822009764,2021.csv,2021,0.0,1.0
68,Wonder Woman,821847012,412563408,409283604,2017.csv,2017,0.501995385973369,0.49800461402663104
69,Spider-Man,821708551,403706375,418002176,2002.csv,2002,0.4913011730359856,0.5086988269640144
70,Fantastic Beasts and Where to Find Them,814037575,234037575,580000000,2016.csv,2016,0.287502177034027,0.7124978229659731
71,Coco,807816196,210460015,597356181,2017.csv,2017,0.2605295809147159,0.7394704190852841
72,Jumanji: The Next Level,801693929,320314960,481378969,2019.csv,2019,0.39954769321946554,0.6004523067805344
73,Harry Potter and the Prisoner of Azkaban,795634069,249541069,546093000,2004.csv,2004,0.31363798852107727,0.6863620114789227
74,Pirates of the Caribbean: Dead Men Tell No Tales,794861794,172558876,622302918,2017.csv,2017,0.21709293024593404,0.782907069754066
75,Mission: Impossible - Fallout,791115104,220159104,570956000,2018.csv,2018,0.27828959766643513,0.7217104023335649
76,Fast & Furious 6,788679850,238679850,550000000,2013.csv,2013,0.30263211365169274,0.6973678863483073
77,Spider-Man 2,788618317,373585825,415032492,2004.csv,2004,0.4737219729072055,0.5262780270927945
78,Deadpool,782612155,363070709,419541446,2016.csv,2016,0.463921633059737,0.536078366940263
79,No Time to Die,774153007,160891007,613262000,2021.csv,2021,0.20782843384344046,0.7921715661565596
80,Guardians of the Galaxy,772776600,333176600,439600000,2014.csv,2014,0.4311421955581988,0.5688578044418011
81,The Batman,770962583,369345583,401617000,2022.csv,2022,0.47907069829872667,0.5209293017012734
82,Thor: Love and Thunder,760928081,343256830,417671251,2022.csv,2022,0.4511028552775936,0.5488971447224065
83,Fast & Furious Presents: Hobbs & Shaw,760732926,173956935,586775991,2019.csv,2019,0.22867017984180166,0.7713298201581983
84,Maleficent,758410378,241410378,517000000,2014.csv,2014,0.31831101604466705,0.681688983955333
85,The Hunger Games: Mockingjay - Part 1,755356711,337135885,418220826,2014.csv,2014,0.44632672231596815,0.5536732776840319
86,Suicide Squad,746846894,325100054,421746840,2016.csv,2016,0.43529678788488074,0.5647032121151193
87,X-Men: Days of Future Past,746045700,233921534,512124166,2014.csv,2014,0.3135485319465014,0.6864514680534985
88,"The Chronicles of Narnia: The Lion, the Witch and the Wardrobe",745013115,291710957,453302158,2005.csv,2005,0.39155143866158654,0.6084485613384135
89,Monsters University,743559607,268492764,475066843,2013.csv,2013,0.3610911102114238,0.6389088897885762
90,The Matrix Reloaded,739412035,281576461,457835574,2003.csv,2003,0.3808113036731949,0.6191886963268052
91,Deadpool 2,734546611,318491426,416055185,2018.csv,2018,0.43358912998919275,0.5664108700108073
92,F9: The Fast Saga,726229501,173005945,553223556,2021.csv,2021,0.23822489276705933,0.7617751072329407
93,Ne Zha,726063471,3695533,722367938,2019.csv,2019,0.005089820859476899,0.9949101791405232
94,Gravity,723192705,274092705,449100000,2013.csv,2013,0.37900369169238235,0.6209963083076177
95,Captain America: The Winter Soldier,714421503,259766572,454654931,2014.csv,2014,0.3636040781376089,0.6363959218623911
96,Dawn of the Planet of the Apes,710644566,208545589,502098977,2014.csv,2014,0.29345976734028806,0.7065402326597119
97,The Amazing Spider-Man 2,708982323,202853933,506128390,2014.csv,2014,0.28611987410580336,0.7138801258941967
98,Fast X,704709660,145960660,558749000,2023.csv,2023,0.2071216960471352,0.7928783039528647
99,It,700381748,327481748,372900000,2017.csv,2017,0.4675760739555994,0.5324239260444006
100,The Wandering Earth,699856699,5971413,693885286,2019.csv,2019,0.008532336703402763,0.9914676632965972
101,Detective Chinatown 3,686257563,0,686257563,2021.csv,2021,0.0,1.0
102,Spider-Man: Across the Spider-Verse,683760323,380072201,303688122,2023.csv,2023,0.5558558872390144,0.4441441127609857
103,Mission: Impossible - Rogue Nation,682714267,195042377,487671890,2015.csv,2015,0.2856866868434727,0.7143133131565274
104,Interstellar,677896797,188020017,489876780,2014.csv,2014,0.2773578778245798,0.7226421221754201
105,Doctor Strange,677718395,232641920,445076475,2016.csv,2016,0.3432722524817996,0.6567277475182004
106,Man of Steel,668045518,291045518,377000000,2013.csv,2013,0.4356671965577052,0.5643328034422948
107,Justice League,657924295,229024295,428900000,2017.csv,2017,0.3481012887660578,0.6518987112339422
108,Big Hero 6,657827828,222527828,435300000,2014.csv,2014,0.33827670178769026,0.6617232982123098
109,Fantastic Beasts: The Crimes of Grindelwald,654855901,159555901,495300000,2018.csv,2018,0.24365039813545178,0.7563496018645482
110,Pirates of the Caribbean: The Curse of the Black Pearl,654264015,305413918,348850097,2003.csv,2003,0.4668053125312111,0.5331946874687888
111,The Hunger Games: Mockingjay - Part 2,653428261,281723902,371704359,2015.csv,2015,0.43114740946290353,0.5688525905370965
112,Star Wars: Episode II - Attack of the Clones,645256452,302191252,343065200,2002.csv,2002,0.4683273620331037,0.5316726379668963
113,Thor: The Dark World,644783140,206362140,438421000,2013.csv,2013,0.32004890822672566,0.6799510917732744
114,Moana,643331111,248757044,394574067,2016.csv,2016,0.38667031602642327,0.6133296839735767
115,Sing,634151679,270395425,363756254,2016.csv,2016,0.42638919670825315,0.5736108032917469
116,The Incredibles,631442092,261441092,370001000,2004.csv,2004,0.4140381126192012,0.5859618873807988
117,The Martian,630161890,228433663,401728227,2015.csv,2015,0.36249996488997455,0.6375000351100255
118,Water Gate Bridge,626571697,117294,626454403,2022.csv,2022,0.00018719964620425553,0.9998128003537957
119,Ant-Man and the Wasp,622674139,216648740,406025399,2018.csv,2018,0.3479327732285988,0.6520672267714012
120,How to Train Your Dragon 2,621537519,177002924,444534595,2014.csv,2014,0.2847823640393944,0.7152176359606056
121,Logan,619021436,226277068,392744368,2017.csv,2017,0.36553995522701094,0.6344600447729891
122,The Passion of the Christ,611486736,370274604,241212132,2004.csv,2004,0.6055317019991747,0.39446829800082533
123,Transformers: The Last Knight,605425157,130168683,475256474,2017.csv,2017,0.21500375644284633,0.7849962435571537
124,War of the Worlds,603873119,234280354,369592765,2005.csv,2005,0.38796287933459084,0.6120371206654092
125,The Croods,587204668,187168425,400036243,2013.csv,2013,0.3187447838885368,0.6812552161114632
126,Ready Player One,582890172,137690172,445200000,2018.csv,2018,0.23621975221774713,0.7637802477822528
127,Operation Red Sea,579330426,1543547,577786879,2018.csv,2018,0.0026643637736368433,0.9973356362263631
128,Fifty Shades of Grey,569651467,166167230,403484237,2015.csv,2015,0.2916998193212763,0.7083001806787237
129,Kong: Skull Island,566652812,168052812,398600000,2017.csv,2017,0.29657103686975084,0.7034289631302492
130,The Little Mermaid,564330882,297102718,267228164,2023.csv,2023,0.5264690051110831,0.473530994888917
131,King Kong,556906378,218080025,338826353,2005.csv,2005,0.3915918969776999,0.6084081030223001
132,The Mermaid,553810228,3232685,550577543,2016.csv,2016,0.005837170995693492,0.9941628290043065
133,Oppenheimer,552943620,228568620,324375000,2023.csv,2023,0.4133669541209283,0.5866330458790717
134,The Day After Tomorrow,552639571,186740799,365898772,2004.csv,2004,0.3379070352528194,0.6620929647471806
135,American Sniper,547426372,350126372,197300000,2014.csv,2014,0.639586234621521,0.3604137653784791
136,Mission: Impossible II,546388108,215409889,330978219,2000.csv,2000,0.3942433699527004,0.6057566300472996
137,Detective Chinatown 2,544185156,1983984,542201172,2018.csv,2018,0.0036457885301083076,0.9963542114698917
138,X-Men: Apocalypse,543934105,155442489,388491616,2016.csv,2016,0.285774485495812,0.7142255145041879
139,Cinderella,542351353,201151353,341200000,2015.csv,2015,0.3708875286976559,0.6291124713023442
140,Madagascar,542063846,193595521,348468325,2005.csv,2005,0.35714523746341126,0.6428547625365887
141,World War Z,540007876,202359711,337648165,2013.csv,2013,0.37473473997997764,0.6252652600200224
142,The Revenant,532950503,183637894,349312609,2015.csv,2015,0.34456838480552104,0.6554316151944789
143,The Meg,530243742,145443742,384800000,2018.csv,2018,0.2742960085703378,0.7257039914296621
144,Ralph Breaks the Internet,529323962,201091711,328232251,2018.csv,2018,0.3799029052835511,0.6200970947164489
145,"Monsters, Inc.",528773250,255873250,272900000,2001.csv,2001,0.48389976232723575,0.5161002376727643
146,Hotel Transylvania 3: Summer Vacation,528583774,167510016,361073758,2018.csv,2018,0.31690343941583043,0.6830965605841696
147,The Boss Baby,527965936,175003033,352962903,2017.csv,2017,0.331466522870521,0.6685334771294791
148,Dunkirk,525245546,188045546,337200000,2017.csv,2017,0.3580145465907482,0.6419854534092517
149,Godzilla,524976069,200676069,324300000,2014.csv,2014,0.38225755582013016,0.6177424441798699
150,Meet the Fockers,522657936,279261160,243396776,2004.csv,2004,0.5343096139269183,0.46569038607308166
151,How to Train Your Dragon: The Hidden World,521799505,160799505,361000000,2019.csv,2019,0.3081633912243746,0.6918366087756255
152,Kung Fu Panda 3,521170825,143528619,377642206,2016.csv,2016,0.2753964959569638,0.7246035040430362
153,Ant-Man,519311965,180202163,339109802,2015.csv,2015,0.3470017545234106,0.6529982454765894
154,The Grinch,511595957,270620950,240975007,2018.csv,2018,0.5289739809261237,0.4710260190738763
155,Venom: Let There Be Carnage,506863592,213550366,293313226,2021.csv,2021,0.42131723282267236,0.5786827671773277
156,Rio 2,498781117,131538435,367242682,2014.csv,2014,0.2637197570572825,0.7362802429427175
157,Troy,497409852,133378256,364031596,2004.csv,2004,0.268145585504004,0.731854414495996
158,Mission: Impossible - Dead Reckoning Part One,493802770,151002770,342800000,2023.csv,2023,0.3057957127295985,0.6942042872704015
159,Oz the Great and Powerful,493311825,234911825,258400000,2013.csv,2013,0.47619337930932426,0.5238066206906757
160,Maleficent: Mistress of Evil,491730089,113929605,377800484,2019.csv,2019,0.23169134358178353,0.7683086564182164
161,War for the Planet of the Apes,490719763,146880162,343839601,2017.csv,2017,0.2993157665019495,0.7006842334980505
162,Mr. & Mrs. Smith,487287646,186336279,300951367,2005.csv,2005,0.38239483502112015,0.6176051649788799
163,Teenage Mutant Ninja Turtles,485004754,191204754,293800000,2014.csv,2014,0.39423274189184543,0.6057672581081546
164,Bruce Almighty,484592874,242829261,241763613,2003.csv,2003,0.5010995291688916,0.49890047083110844
165,Shrek,484409218,267665011,216744207,2001.csv,2001,0.5525596975737155,0.4474403024262845
166,Puss in Boots: The Last Wish,481048593,185535345,295513248,2022.csv,2022,0.38568940373140226,0.6143105962685977
167,Ant-Man and the Wasp: Quantumania,476071180,214504909,261566271,2023.csv,2023,0.45057318739605284,0.5494268126039472
168,Charlie and the Chocolate Factory,474968763,206459076,268509687,2005.csv,2005,0.43467927173981336,0.5653207282601866
169,Hotel Transylvania 2,474800000,169700110,305099890,2015.csv,2015,0.3574138795282224,0.6425861204717775
170,San Andreas,473990832,155190832,318800000,2015.csv,2015,0.32741315131597315,0.6725868486840269
171,It Chapter Two,473093228,211593228,261500000,2019.csv,2019,0.44725482310222375,0.5527451768977762
172,Godzilla vs. Kong,470116094,100916094,369200000,2021.csv,2021,0.21466207025875614,0.7853379297412438
173,The Lego Movie,468060692,257760692,210300000,2014.csv,2014,0.5506992926464331,0.44930070735356686
174,Bumblebee,467989645,127195589,340794056,2018.csv,2018,0.2717914602576303,0.7282085397423698
175,Star Trek Into Darkness,467365246,228778661,238586585,2013.csv,2013,0.4895072172311246,0.5104927827688753
176,The Eight Hundred,461421559,372755,461048804,2020.csv,2020,0.0008078404502985089,0.9991921595497015
177,Gladiator,460583960,187705427,272878533,2000.csv,2000,0.4075379155626696,0.5924620844373304
178,Moon Man,460237662,0,460237662,2022.csv,2022,0.0,1.0
179,Lucy,458863600,126663600,332200000,2014.csv,2014,0.27603758502526676,0.7239624149747332
180,The Last Samurai,454627263,111127263,343500000,2003.csv,2003,0.24443598535356645,0.7555640146464335
181,Demon Slayer the Movie: Mugen Train,453210959,49505008,403705951,2020.csv,2020,0.10923170990664416,0.8907682900933558
182,Dying to Survive,451176639,0,451176639,2018.csv,2018,0.0,1.0
183,Ocean's Eleven,450717150,183417150,267300000,2001.csv,2001,0.4069451317749946,0.5930548682250054
184,"My People, My Country",450064993,2356683,447708310,2019.csv,2019,0.005236317057878794,0.9947636829421213
185,Pearl Harbor,449220945,198542554,250678391,2001.csv,2001,0.44197083018914,0.55802916981086
186,La La Land,447407695,151101803,296305892,2016.csv,2016,0.3377273227274287,0.6622726772725712
187,Men in Black II,441818803,190418803,251400000,2002.csv,2002,0.43098845433248795,0.569011545667512
188,Terminator Genisys,440603537,89760956,350842581,2015.csv,2015,0.20372273134974855,0.7962772686502514
189,Warcraft,439048914,47365290,391683624,2016.csv,2016,0.10788157877097038,0.8921184212290296
190,A Star Is Born,436188866,215288866,220900000,2018.csv,2018,0.4935679995096436,0.5064320004903564
191,The Greatest Showman,434993183,174340174,260653009,2017.csv,2017,0.4007882900546513,0.5992117099453488
192,Transformers: Rise of the Beasts,433713663,157013663,276700000,2023.csv,2023,0.3620214819010671,0.6379785180989329
193,Terminator 3: Rise of the Machines,433371112,150371112,283000000,2003.csv,2003,0.34698000821060726,0.6530199917893927
194,The Mummy Returns,433013274,202019785,230993489,2001.csv,2001,0.46654409259518453,0.5334559074048155
195,Pokémon: Detective Pikachu,433005346,144105346,288900000,2019.csv,2019,0.3328026947731957,0.6671973052268043
196,Shang-Chi and the Legend of the Ten Rings,432243292,224543292,207700000,2021.csv,2021,0.5194835782437082,0.48051642175629183
197,Die Another Day,431971116,160942139,271028977,2002.csv,2002,0.37257615854111875,0.6274238414588812
198,The Secret Life of Pets 2,431058604,158874395,272184209,2019.csv,2019,0.3685679708645834,0.6314320291354166
199,Cast Away,429632142,233632142,196000000,2000.csv,2000,0.5437957712204875,0.4562042287795125
200,Rampage,428028233,101028233,327000000,2018.csv,2018,0.2360317035441912,0.7639682964558088
201,The Matrix Revolutions,427343298,139313948,288029350,2003.csv,2003,0.32600007687496246,0.6739999231250375
202,John Wick: Chapter 4,426978565,187131806,239846759,2023.csv,2023,0.4382697899600651,0.561730210039935
203,Bad Boys for Life,426505244,206305244,220200000,2020.csv,2020,0.4837109200936343,0.5162890799063657
204,Elemental,423698938,148298938,275400000,2023.csv,2023,0.35001017160916276,0.6499898283908373
205,"My People, My Homeland",422390820,0,422390820,2020.csv,2020,0.0,1.0
206,The Captain,417282021,706572,416575449,2019.csv,2019,0.0016932720904359309,0.9983067279095641
207,Jason Bourne,415484914,162434410,253050504,2016.csv,2016,0.39095140287091146,0.6090485971290885
208,The Wolverine,414828246,132556852,282271394,2013.csv,2013,0.3195463502743253,0.6804536497256747
209,Kingsman: The Secret Service,414351546,128261724,286089822,2015.csv,2015,0.3095480763573644,0.6904519236426355
210,Pacific Rim,411002906,101802906,309200000,2013.csv,2013,0.24769388370212642,0.7523061162978736
211,Kingsman: The Golden Circle,410902662,100234838,310667824,2017.csv,2017,0.24393815681826855,0.7560618431817314
212,The Mummy,409231607,80227895,329003712,2017.csv,2017,0.196045206742792,0.803954793257208
213,Ice Age: Collision Course,408579038,64063008,344516030,2016.csv,2016,0.15679465180981703,0.843205348190183
214,Sing 2,408391841,162790990,245600851,2021.csv,2021,0.39861469710409814,0.6013853028959019
215,Signs,408247917,227966634,180281283,2002.csv,2002,0.5584024425040728,0.44159755749592716
216,X2: X-Men United,407711549,214949694,192761855,2003.csv,2003,0.5272102164562427,0.4727897835437573
217,Fantastic Beasts: The Secrets of Dumbledore,407150844,95850844,311300000,2022.csv,2022,0.23541850744634585,0.7645814925536542
218,Uncharted,407141258,148648820,258492438,2022.csv,2022,0.36510379893751765,0.6348962010624823
219,Sonic the Hedgehog 2,405421518,190872904,214548614,2022.csv,2022,0.4708011181587061,0.5291988818412939
220,Alita: Battle Angel,404980543,85838210,319142333,2019.csv,2019,0.21195638033405473,0.7880436196659453
221,Eternals,402064899,164870234,237194665,2021.csv,2021,0.41005876019035425,0.5899412398096457
222,Dune,402027830,108327830,293700000,2021.csv,2021,0.26945355996872156,0.7305464400312784
223,Mamma Mia! Here We Go Again,395044706,120634935,274409771,2018.csv,2018,0.3053703369967449,0.6946296630032551
224,Black Adam,393252111,168152111,225100000,2022.csv,2022,0.42759366395365644,0.5724063360463436
225,Solo: A Star Wars Story,392924807,213767512,179157295,2018.csv,2018,0.5440417815106289,0.4559582184893712
226,The Wolf of Wall Street,392000694,116900694,275100000,2013.csv,2013,0.2982155281592435,0.7017844718407565
227,Independence Day: Resurgence,389681935,103144286,286537649,2016.csv,2016,0.26468839516514925,0.7353116048348508
228,Monster Hunt,387053506,32766,387020740,2015.csv,2015,8.465496240718718e-05,0.9999153450375928
229,Godzilla: King of the Monsters,386600138,110500138,276100000,2019.csv,2019,0.2858253971963145,0.7141746028036855
230,Home,386041607,177397510,208644097,2015.csv,2015,0.45952950869360565,0.5404704913063944
231,1917,384579437,159227644,225351793,2019.csv,2019,0.41403057127050713,0.5859694287294929
232,Cars 3,383930656,152901115,231029541,2017.csv,2017,0.3982519046356121,0.6017480953643879
233,Ice Age,383257136,176387405,206869731,2002.csv,2002,0.4602325395449388,0.5397674604550612
234,Fifty Shades Darker,381545846,114581250,266964596,2017.csv,2017,0.3003079477898444,0.6996920522101556
235,Black Widow,379751655,183651655,196100000,2021.csv,2021,0.4836098870984512,0.5163901129015488
236,Once Upon a Time in Hollywood,377426903,142502728,234924175,2019.csv,2019,0.3775637795485925,0.6224362204514076
237,G.I. Joe: Retaliation,375740705,122523060,253217645,2013.csv,2013,0.3260840743884802,0.6739159256115198
238,Spider-Man: Into the Spider-Verse,375540831,190241310,185299521,2018.csv,2018,0.5065795628491859,0.49342043715081413
239,Mad Max: Fury Road,374736354,153636354,221100000,2015.csv,2015,0.4099851865453118,0.5900148134546882
240,Shark Tale,374583879,160861908,213721971,2004.csv,2004,0.42944162047080514,0.5705583795291949
241,What Women Want,374111707,182811707,191300000,2000.csv,2000,0.4886554031307018,0.5113445968692982
242,Penguins of Madagascar,373515621,83850911,289664710,2014.csv,2014,0.22449104210289508,0.775508957897105
243,Fifty Shades Freed,371985018,100407760,271577258,2018.csv,2018,0.26992420431298125,0.7300757956870187
244,Batman Begins,371853783,205343774,166510009,2005.csv,2005,0.552216444709398,0.44778355529060193
245,Hitch,371594210,179495555,192098655,2005.csv,2005,0.48304185094810814,0.5169581490518919
246,Edge of Tomorrow,370541256,100206256,270335000,2014.csv,2014,0.2704321162013873,0.7295678837986127
247,Gone Girl,369330363,167767189,201563174,2014.csv,2014,0.4542469447604014,0.5457530552395986
248,Jurassic Park III,368780809,181171875,187608934,2001.csv,2001,0.49127251358679025,0.5087274864132098
249,My Big Fat Greek Wedding,368744044,241438208,127305836,2002.csv,2002,0.6547582582784713,0.34524174172152866
250,Indiana Jones and the Dial of Destiny,368440059,170640059,197800000,2023.csv,2023,0.4631419815292126,0.5368580184707874
251,Hello Mr. Billionaire,366961907,0,366961907,2018.csv,2018,0.0,1.0
252,Shazam!,365971656,140371656,225600000,2019.csv,2019,0.3835588185550632,0.6164411814449369
253,The Nun,365550119,117450119,248100000,2018.csv,2018,0.32129689718415877,0.6787031028158412
254,Tenet,365304105,58504105,306800000,2020.csv,2020,0.16015178641367855,0.8398482135863214
255,Night at the Museum: Secret of the Tomb,363204635,113746621,249458014,2014.csv,2014,0.313175025973994,0.6868249740260061
256,Ocean's Twelve,362744280,125544280,237200000,2004.csv,2004,0.34609582265501193,0.6539041773449881
257,Planet of the Apes,362211740,180011740,182200000,2001.csv,2001,0.4969793082907804,0.5030206917092196
258,The Hangover Part III,362000072,112200072,249800000,2013.csv,2013,0.3099448886297459,0.6900551113702541
259,Monster Hunt 2,361682618,706153,360976465,2018.csv,2018,0.0019524106629862981,0.9980475893370137
260,Noah,359200044,101200044,258000000,2014.csv,2014,0.28173728174710355,0.7182627182528964
261,Minority Report,358372926,132072926,226300000,2002.csv,2002,0.3685348875936013,0.6314651124063987
262,Your Name.,357986087,5017246,352968841,2016.csv,2016,0.014015198305737508,0.9859848016942625
263,The Legend of Tarzan,356700357,126643061,230057296,2016.csv,2016,0.3550404660794887,0.6449595339205113
264,The Great Gatsby,353641895,144840419,208801476,2013.csv,2013,0.40956804340164504,0.5904319565983549
265,Dumbo,353284621,114766307,238518314,2019.csv,2019,0.32485508900768145,0.6751449109923185
266,"I, Robot",353133898,144801023,208332875,2004.csv,2004,0.4100456620564928,0.5899543379435072
267,Murder on the Orient Express,352789811,102826543,249963268,2017.csv,2017,0.29146687289106543,0.7085331271089346
268,The Angry Birds Movie,352333929,107509366,244824563,2016.csv,2016,0.3051348653964007,0.6948651346035993
269,Catch Me If You Can,352114312,164615351,187498961,2002.csv,2002,0.4675054247723961,0.5324945752276039
270,Now You See Me,351723989,117723989,234000000,2013.csv,2013,0.3347056006464205,0.6652943993535795
271,Hannibal,351692268,165092268,186600000,2001.csv,2001,0.46942251229702897,0.5305774877029711
272,Peter Rabbit,351266433,115253424,236013009,2018.csv,2018,0.3281082767165515,0.6718917232834485
273,Dinosaur,349822765,137748063,212074702,2000.csv,2000,0.39376529140406286,0.6062347085959372
274,Mary Poppins Returns,349537494,171958438,177579056,2018.csv,2018,0.4919599211865952,0.5080400788134047
275,The Maze Runner,348319861,102427862,245891999,2014.csv,2014,0.2940626517992323,0.7059373482007677
276,The Smurfs 2,347545360,71017784,276527576,2013.csv,2013,0.2043410506185437,0.7956589493814563
277,National Treasure,347512318,173008894,174503424,2004.csv,2004,0.4978496733459675,0.5021503266540325
278,Rush Hour 2,347325802,226164286,121161516,2001.csv,2001,0.6511588966258257,0.3488411033741743
279,Trolls,346864462,153707064,193157398,2016.csv,2016,0.44313292608223437,0.5568670739177656
280,xXx: Return of Xander Cage,346118277,44898413,301219864,2017.csv,2017,0.12971985585147242,0.8702801441485276
281,How the Grinch Stole Christmas,345141403,260044825,85096578,2000.csv,2000,0.7534443064195344,0.24655569358046564
282,Star Trek Beyond,343471816,158848340,184623476,2016.csv,2016,0.462478528369268,0.537521471630732
283,A Quiet Place,340939361,188024361,152915000,2018.csv,2018,0.5514891576276522,0.44851084237234784
284,300: Rise of an Empire,337580051,106580051,231000000,2014.csv,2014,0.31571785916935,0.68428214083065
285,The Great Wall,334933831,45540830,289393001,2016.csv,2016,0.13596963276008986,0.8640303672399101
286,Now You See Me 2,334897606,65075540,269822066,2016.csv,2016,0.19431473630778956,0.8056852636922105
287,Never Say Die,334530869,0,334530869,2017.csv,2017,0.0,1.0
288,Fantastic Four,333535934,154696080,178839854,2005.csv,2005,0.46380633758040596,0.5361936624195941
289,The Good Dinosaur,332207671,123087120,209120551,2015.csv,2015,0.3705125761530052,0.6294874238469947
290,Free Guy,331526598,121626598,209900000,2021.csv,2021,0.36686829573776764,0.6331317042622324
291,22 Jump Street,331333876,191719337,139614539,2014.csv,2014,0.5786288420445123,0.4213711579554878
292,Meet the Parents,330444045,166244045,164200000,2000.csv,2000,0.5030928761327806,0.49690712386721936
293,The Perfect Storm,328718434,182618434,146100000,2000.csv,2000,0.5555466779815579,0.44445332201844207
294,John Wick: Chapter 3 - Parabellum,327777335,171015687,156761648,2019.csv,2019,0.5217434786941568,0.4782565213058432
295,Crazy Alien,327598891,0,327598891,2019.csv,2019,0.0,1.0
296,Taken 3,326479141,89256424,237222717,2015.csv,2015,0.27339089329446625,0.7266091067055338
297,The SpongeBob Movie: Sponge Out of Water,325186032,162994032,162192000,2015.csv,2015,0.5012331894993571,0.4987668105006429
298,Green Book,321752656,85080171,236672485,2018.csv,2018,0.26442725308847176,0.7355727469115282
299,The Conjuring 2,320392818,102470008,217922810,2016.csv,2016,0.31982617038562955,0.6801738296143705
300,Sonic the Hedgehog,319715683,148974665,170741018,2020.csv,2020,0.46595982906475064,0.5340401709352494
301,The Conjuring,319494638,137400141,182094497,2013.csv,2013,0.4300546070510266,0.5699453929489734
302,Chicken Little,314432837,135386665,179046172,2005.csv,2005,0.4305741928601433,0.5694258071398567
303,A Beautiful Mind,313542341,170742341,142800000,2001.csv,2001,0.5445591190505272,0.45544088094947277
304,Knives Out,312897920,165363234,147534686,2019.csv,2019,0.5284893999934548,0.47151060000654527
305,Maze Runner: The Scorch Trials,312296056,81697192,230598864,2015.csv,2015,0.2616017411375826,0.7383982588624174
306,Resident Evil: The Final Chapter,312242626,26830068,285412558,2016.csv,2016,0.085926986791355,0.914073013208645
307,The Lego Batman Movie,311950384,175750384,136200000,2017.csv,2017,0.5633921066114155,0.4366078933885845
308,The Ex-File 3: Return of the Exes,307592427,838959,306753468,2017.csv,2017,0.002727502130603495,0.9972724978693965
309,The Fault in Our Stars,307166834,124872350,182294484,2014.csv,2014,0.40652940414784494,0.593470595852155
310,Chicago,306776732,170687518,136089214,2002.csv,2002,0.556390039385386,0.443609960614614
311,Annabelle: Creation,306515884,102092201,204423683,2017.csv,2017,0.33307311734617967,0.6669268826538203
312,Wonder,305937718,132422809,173514909,2017.csv,2017,0.43284237676114196,0.5671576232388581
313,Skyscraper,304868961,68420120,236448841,2018.csv,2018,0.22442468323300382,0.7755753167669962
314,A Good Day to Die Hard,304654182,67349198,237304984,2013.csv,2013,0.22106769569964413,0.7789323043003559
315,Dangal,303723636,12391761,291331875,2016.csv,2016,0.04079946217949267,0.9592005378205073
316,Passengers,303144152,100014699,203129453,2016.csv,2016,0.3299245535173642,0.6700754464826357
317,Van Helsing,300157638,120177084,179980554,2004.csv,2004,0.4003798963796483,0.5996201036203517
318,Alice Through the Looking Glass,299457024,77041381,222415643,2016.csv,2016,0.257270241889534,0.7427297581104659
319,Ocean's Eight,297718711,140218711,157500000,2018.csv,2018,0.47097715333048046,0.5290228466695195
320,A Quiet Place Part II,297372261,160072261,137300000,2021.csv,2021,0.5382891479578857,0.4617108520421143
321,The Divergent Series: Insurgent,297002527,130179072,166823455,2015.csv,2015,0.4383096444159211,0.5616903555840789
322,Austin Powers in Goldmember,296938801,213307889,83630912,2002.csv,2002,0.7183564030084435,0.2816435969915565
323,Miss Peregrine's Home for Peculiar Children,296482446,87242834,209239612,2016.csv,2016,0.29425969455203427,0.7057403054479657
324,X-Men,296339528,157299718,139039810,2000.csv,2000,0.5308090994867212,0.46919090051327883
325,Ferdinand,296069199,84410380,211658819,2017.csv,2017,0.28510355107894897,0.7148964489210511
326,What Lies Beneath,291420351,155464351,135956000,2000.csv,2000,0.533471154181679,0.46652884581832105
327,Pacific Rim: Uprising,290930148,59874525,231055623,2018.csv,2018,0.20580378283793402,0.794196217162066
328,The Bourne Supremacy,290633422,176241941,114391481,2004.csv,2004,0.6064063100079384,0.39359368999206157
329,Divergent,288885818,150947895,137937923,2014.csv,2014,0.5225174985917792,0.47748250140822074
330,Wedding Crashers,288467645,209255921,79211724,2005.csv,2005,0.7254051697894923,0.2745948302105077
331,Maze Runner: The Death Cure,288175335,58032443,230142892,2018.csv,2018,0.2013789382772818,0.7986210617227182
332,Elvis,287740048,151040048,136700000,2022.csv,2022,0.5249184082988684,0.47508159170113157
333,American Pie 2,287553595,145103595,142450000,2001.csv,2001,0.5046140876798985,0.4953859123201016
334,Pitch Perfect 2,287144079,184296230,102847849,2015.csv,2015,0.6418249355578737,0.35817506444212627
335,Oblivion,286168572,89107235,197061337,2013.csv,2013,0.3113802273158074,0.6886197726841926
336,Elysium,286140700,93050117,193090583,2013.csv,2013,0.3251900795657521,0.6748099204342479
337,The Polar Express,286000505,162775358,123225147,2004.csv,2004,0.5691436034352457,0.43085639656475433
338,Turbo,282570682,83028128,199542554,2013.csv,2013,0.29383136074959115,0.7061686392504088
339,Paddington,282370135,76271832,206098303,2014.csv,2014,0.2701129565277858,0.7298870434722142
340,Bridget Jones's Diary,281929795,71543427,210386368,2001.csv,2001,0.25376327110087815,0.7462367288991218
341,Split,278454358,138291365,140162993,2017.csv,2017,0.4966392553281569,0.5033607446718431
342,Scary Movie,278019771,157019771,121000000,2000.csv,2000,0.5647791537818366,0.43522084621816337
343,xXx,277448382,142109382,135339000,2002.csv,2002,0.5122011560334131,0.4877988439665869
344,Mr. Peabody & Sherman,275698039,111506430,164191609,2014.csv,2014,0.4044512989807664,0.5955487010192336
345,Scooby-Doo,275650703,153294164,122356539,2002.csv,2002,0.556117442588202,0.44388255741179805
346,Creed III,275248615,156248615,119000000,2023.csv,2023,0.5676635829757036,0.43233641702429637
347,Spirited Away,274925095,10055859,264869236,2001.csv,2001,0.03657672283426873,0.9634232771657313
348,Lara Croft: Tomb Raider,274703340,131168070,143535270,2001.csv,2001,0.4774898987394911,0.5225101012605089
349,Tomb Raider,274650803,58250803,216400000,2018.csv,2018,0.21209041577060309,0.7879095842293969
350,Cloudy with a Chance of Meatballs 2,274325949,119793567,154532382,2013.csv,2013,0.43668332302023677,0.5633166769797632
351,Bad Boys II,273339556,138608444,134731112,2003.csv,2003,0.5070925190205547,0.4929074809794452
352,Lilo & Stitch,273144151,145794338,127349813,2002.csv,2002,0.5337633534023578,0.46623664659764213
353,Neighbors,270665134,150157400,120507734,2014.csv,2014,0.5547718606416444,0.44522813935835565
354,Epic,268426634,107518682,160907952,2013.csv,2013,0.4005514668861064,0.5994485331138936
355,The Flash,268394849,107994849,160400000,2023.csv,2023,0.402373031384071,0.597626968615929
356,Exodus: Gods and Kings,268175631,65014513,203161118,2014.csv,2014,0.24243259075243864,0.7575674092475614
357,Something's Gotta Give,265328738,124728738,140600000,2003.csv,2003,0.4700913249736257,0.5299086750263743
358,Bridget Jones: The Edge of Reason,265126918,40226215,224900703,2004.csv,2004,0.15172437149516443,0.8482756285048355
359,Charlie's Angels,264105545,125305545,138800000,2000.csv,2000,0.47445253373987284,0.5255474662601272
360,Robots,262511490,128200012,134311478,2005.csv,2005,0.48835962189693105,0.511640378103069
361,Terminator: Dark Fate,261119292,62253077,198866215,2019.csv,2019,0.23840856998034446,0.7615914300196556
362,The Lone Ranger,260502115,89302115,171200000,2013.csv,2013,0.34280763900899613,0.6571923609910039
363,Mojin: The Lost Legend,259368448,1243810,258124638,2015.csv,2015,0.004795533186827721,0.9952044668131723
364,Blade Runner 2049,259239658,92054159,167185499,2017.csv,2017,0.35509288860425825,0.6449071113957418
365,Charlie's Angels: Full Throttle,259175788,100830111,158345677,2003.csv,2003,0.38904139841951596,0.6109586015804841
366,Parasite,258710043,53369749,205340294,2019.csv,2019,0.20629175574757258,0.7937082442524274
367,Kung Fu Yoga,257743016,362657,257380359,2017.csv,2017,0.0014070487946800467,0.99859295120532
368,Annabelle,257047661,84273813,172773848,2014.csv,2014,0.3278528684997449,0.6721471315002551
369,Encanto,256786742,96093622,160693120,2021.csv,2021,0.37421566725590527,0.6257843327440947
370,The Village,256697520,114197520,142500000,2003.csv,2003,0.44487192552541993,0.55512807447458
371,Lost in Hong Kong,256283912,1302281,254981631,2015.csv,2015,0.005081399725161055,0.9949186002748389
372,Erin Brockovich,256271286,125595205,130676081,2000.csv,2000,0.4900869190627935,0.5099130809372066
373,Us,256022707,175084580,80938127,2019.csv,2019,0.6838634824683734,0.3161365175316266
374,Pegasus,255863112,0,255863112,2019.csv,2019,0.0,1.0
375,Halloween,255485178,159342015,96143163,2018.csv,2018,0.6236839892136522,0.37631601078634785
376,Get Out,255407969,176040665,79367304,2017.csv,2017,0.6892528282858708,0.31074717171412924
377,Baahubali 2: The Conclusion,254158390,20186659,233971731,2017.csv,2017,0.07942550706274147,0.9205744929372586
378,Men in Black: International,253890701,80001807,173888894,2019.csv,2019,0.31510333653377876,0.6848966634662212
379,X-Men: Dark Phoenix,252442974,65845974,186597000,2019.csv,2019,0.26083504308580996,0.73916495691419
380,Dolittle,251410631,77047065,174363566,2020.csv,2020,0.3064590574135268,0.6935409425864733
381,American Hustle,251171807,150117807,101054000,2013.csv,2013,0.5976698133162692,0.4023301866837308
382,Brother Bear,250397798,85336277,165061521,2003.csv,2003,0.34080282527085165,0.6591971747291484
383,The Bad Guys,250162278,97233630,152928648,2022.csv,2022,0.38868222170570416,0.6113177782942958
384,The Ring,249348933,129128133,120220800,2002.csv,2002,0.5178611813029094,0.48213881869709063
385,Unbreakable,248118121,95011339,153106782,2000.csv,2000,0.3829278515292319,0.6170721484707681
386,Journey to the West: The Demons Strike Back,247585244,880346,246704898,2017.csv,2017,0.0035557288704976295,0.9964442711295024
387,Glass,246999039,111048468,135950571,2019.csv,2019,0.44959068848846817,0.5504093115115318
388,Grown Ups 2,246984278,133668525,113315753,2013.csv,2013,0.5412025659382255,0.4587974340617746
389,The Peanuts Movie,246233113,130178411,116054702,2015.csv,2015,0.5286795484732388,0.47132045152676116
390,Teenage Mutant Ninja Turtles: Out of the Shadows,245623848,82051601,163572247,2016.csv,2016,0.3340538863311025,0.6659461136688974
391,Hulk,245285165,132177234,113107931,2003.csv,2003,0.5388717006183394,0.4611282993816605
392,The Bravest,245179562,290217,244889345,2019.csv,2019,0.0011836916488169597,0.9988163083511831
393,Love Actually,244931766,59696144,185235622,2003.csv,2003,0.24372560968674026,0.7562743903132597
394,Pixels,244874809,78747585,166127224,2015.csv,2015,0.3215830379677805,0.6784169620322195
395,Hercules,244819862,72688614,172131248,2014.csv,2014,0.29690652304999665,0.7030934769500033
396,After Earth,243611982,60522097,183089885,2013.csv,2013,0.24843645416422908,0.7515635458357709
397,8 Mile,242875078,116750901,126124177,2002.csv,2002,0.48070350388111865,0.5192964961188813
398,Daddy's Home,242786137,150357137,92429000,2015.csv,2015,0.6192986916711806,0.38070130832881943
399,RoboCop,242688965,58607007,184081958,2014.csv,2014,0.24149020125410317,0.7585097987458969
400,Alien: Covenant,240891763,74262031,166629732,2017.csv,2017,0.3082796608533269,0.6917203391466731
401,Sully,240797623,125070033,115727590,2016.csv,2016,0.5193989518742052,0.48060104812579485
402,Assassin's Creed,240697856,54647948,186049908,2016.csv,2016,0.2270396126835463,0.7729603873164537
403,Legend of Deification,240646355,214670,240431685,2020.csv,2020,0.0008920558967120029,0.999107944103288
404,Bullet Train,239268602,103368602,135900000,2022.csv,2022,0.43201908288827634,0.5679809171117237
405,Planes,239258712,90288712,148970000,2013.csv,2013,0.37736854489127236,0.6226314551087276
406,Crazy Rich Asians,238532921,174532921,64000000,2018.csv,2018,0.7316932198218459,0.2683067801781541
407,Gone in 60 Seconds,237202299,101648571,135553728,2000.csv,2000,0.4285311374659147,0.5714688625340854
408,2 Fast 2 Furious,236350661,127154901,109195760,2003.csv,2003,0.5379925762086191,0.4620074237913809
409,Hidden Figures,235956898,169607287,66349611,2016.csv,2016,0.7188062245164792,0.2811937754835207
410,A.I. Artificial Intelligence,235926552,78616689,157309863,2001.csv,2001,0.33322527004082186,0.6667747299591782
411,Spy,235666219,110825712,124840507,2015.csv,2015,0.47026558354551445,0.5297344164544856
412,Howl's Moving Castle,235347345,4711096,230636249,2004.csv,2004,0.020017629686878344,0.9799823703131216
413,Alvin and the Chipmunks: The Road Chip,234798636,85886987,148911649,2015.csv,2015,0.3657899741802589,0.6342100258197412
414,The Imitation Game,233555708,91125683,142430025,2014.csv,2014,0.39016679909188945,0.6098332009081106
415,Cruella,233503234,86103234,147400000,2021.csv,2021,0.3687453596467105,0.6312546403532895
416,American Wedding,232722935,104565114,128157821,2003.csv,2003,0.4493115987902095,0.5506884012097906
417,Annabelle Comes Home,231252591,74152591,157100000,2019.csv,2019,0.32065626023623667,0.6793437397637634
418,Constantine,230884728,75976178,154908550,2005.csv,2005,0.32906541137705736,0.6709345886229426
419,The Heat,229930771,159582188,70348583,2013.csv,2013,0.6940445043782331,0.30595549562176694
420,Ghostbusters,229147509,128350574,100796935,2016.csv,2016,0.5601220565744837,0.43987794342551634
421,Goodbye Mr. Loser,228122928,1293626,226829302,2015.csv,2015,0.005670740820931423,0.9943292591790686
422,Paddington 2,227978523,40891591,187086932,2017.csv,2017,0.17936597913655225,0.8206340208634477
423,Youth,227091290,1891956,225199334,2017.csv,2017,0.00833125744276674,0.9916687425572333
424,Baby Driver,226945087,107825862,119119225,2017.csv,2017,0.47511873213628986,0.5248812678637101
425,Lightyear,226425420,118307188,108118232,2022.csv,2022,0.5224995850730894,0.4775004149269106
426,Hansel & Gretel: Witch Hunters,226349749,55703475,170646274,2013.csv,2013,0.2460947062945495,0.7539052937054505
427,Better Days,225918798,1921657,223997141,2019.csv,2019,0.008505963279779843,0.9914940367202202
428,Valerian and the City of a Thousand Planets,225874228,41189488,184684740,2017.csv,2017,0.18235585513545174,0.8176441448645483
429,Ford v Ferrari,225508210,117624357,107883853,2019.csv,2019,0.521596783549477,0.47840321645052303
430,Chicken Run,224834564,106834564,118000000,2000.csv,2000,0.47516966297050306,0.524830337029497
431,Flightplan,223387299,89707299,133680000,2005.csv,2005,0.40157743704130644,0.5984225629586936
432,Non-Stop,222809600,92168600,130641000,2014.csv,2014,0.4136652998793589,0.5863347001206412
433,Fahrenheit 9/11,222446882,119194771,103252111,2004.csv,2004,0.5358347571713772,0.4641652428286228
434,"My Country, My Parents",221831086,177133,221653953,2021.csv,2021,0.0007985039571956114,0.9992014960428044
435,Geostorm,221600160,33700160,187900000,2017.csv,2017,0.15207642449355632,0.8479235755064437
436,Jungle Cruise,220889446,116987516,103901930,2021.csv,2021,0.5296202155353317,0.4703797844646684
437,Scary Movie 3,220673217,110003217,110670000,2003.csv,2003,0.4984892072335176,0.5015107927664824
438,Elf,220443451,173398518,47044933,2003.csv,2003,0.7865895639603283,0.2134104360396717
439,Collateral,220239925,101005703,119234222,2004.csv,2004,0.4586166790603475,0.5413833209396525
440,Inferno,220021259,34343574,185677685,2016.csv,2016,0.15609207108482184,0.8439079289151782
441,Little Women,218843645,108101214,110742431,2019.csv,2019,0.4939655158823552,0.5060344841176448
442,Captain Phillips,218791811,107100855,111690956,2013.csv,2013,0.4895103455220269,0.5104896544779731
443,The Terminal,218685607,77872883,140812724,2004.csv,2004,0.35609514530144637,0.6439048546985536
444,Kingdom of Heaven,218122627,47398413,170724214,2005.csv,2005,0.2173016786561992,0.7826983213438008
445,The Emoji Movie,217776646,86089513,131687133,2017.csv,2017,0.39531104267259215,0.6046889573274078
446,Smile,217408513,105935048,111473465,2022.csv,2022,0.487262649186143,0.5127373508138571
447,Too Cool to Kill,217254604,185882,217068722,2022.csv,2022,0.000855595216753151,0.9991444047832468
448,Dracula Untold,217124280,56280355,160843925,2014.csv,2014,0.2592080213230874,0.7407919786769126
449,Central Intelligence,216972543,127440871,89531672,2016.csv,2016,0.5873594383783389,0.412640561621661
450,Million Dollar Baby,216763646,100492203,116271443,2004.csv,2004,0.4636026605679072,0.5363973394320928
451,A Little Red Flower,216000000,0,216000000,2020.csv,2020,0.0,1.0
452,The Croods: A New Age,215905815,58568815,157337000,2020.csv,2020,0.271270206409216,0.728729793590784
453,Ted 2,215863606,81476385,134387221,2015.csv,2015,0.37744382441197616,0.6225561755880239
454,Vertical Limit,215663859,69243859,146420000,2000.csv,2000,0.3210730778957266,0.6789269221042734
455,The Patriot,215294342,113330342,101964000,2000.csv,2000,0.5263972148418095,0.47360278515819054
456,The Expendables 3,214657577,39322544,175335033,2014.csv,2014,0.18318730952599918,0.8168126904740008
457,Creed II,214215889,115715889,98500000,2018.csv,2018,0.5401835015142131,0.45981649848578693
458,Smallfoot,214040103,83240103,130800000,2018.csv,2018,0.3888995652370808,0.6111004347629192
459,The Bourne Identity,214034224,121661683,92372541,2002.csv,2002,0.5684216324208039,0.4315783675791961
460,The Aviator,213719942,102610330,111109612,2004.csv,2004,0.4801158424420684,0.5198841575579316
461,"Crouching Tiger, Hidden Dragon",213525736,128078872,85446864,2000.csv,2000,0.5998287344622477,0.40017126553775234
462,Into the Woods,212902372,128002372,84900000,2014.csv,2014,0.6012256735213829,0.39877432647861716
463,Miss Congeniality,212742720,106807667,105935053,2000.csv,2000,0.502050866887478,0.49794913311252204
464,Bridget Jones's Baby,211952420,24252420,187700000,2016.csv,2016,0.11442388815376583,0.8855761118462342
465,Fury,211817906,85817906,126000000,2014.csv,2014,0.4051494400100433,0.5948505599899566
466,Master and Commander: The Far Side of the World,211622535,93927920,117694615,2003.csv,2003,0.44384649300226936,0.5561535069977307
467,A Series of Unfortunate Events,211468235,118634549,92833686,2004.csv,2004,0.5610041101444858,0.43899588985551424
468,Nice View,211019042,0,211019042,2022.csv,2022,0.0,1.0
469,The Others,209947037,96522687,113424350,2001.csv,2001,0.4597477934399236,0.5402522065600764
470,Us and Them,209221380,0,209221380,2018.csv,2018,0.0,1.0
471,Red Dragon,209196298,93149898,116046400,2002.csv,2002,0.44527507843374936,0.5547249215662506
472,Tomorrowland,209035668,93436322,115599346,2015.csv,2015,0.44698745861878464,0.5530125413812154
473,Me Before You,208314186,56245075,152069111,2016.csv,2016,0.2700011750519957,0.7299988249480043
474,Dungeons & Dragons: Honor Among Thieves,208177026,93277026,114900000,2023.csv,2023,0.44806589753088316,0.5519341024691168
475,S.W.A.T.,207725639,116934650,90790989,2003.csv,2003,0.562928344151104,0.43707165584889596
476,DC League of Super-Pets,207557117,93657117,113900000,2022.csv,2022,0.45123539175002125,0.5487646082499787
477,Traffic,207515725,124115725,83400000,2000.csv,2000,0.5981027461894756,0.4018972538105245
478,The Fast and the Furious,207283925,144533925,62750000,2001.csv,2001,0.697275126375574,0.302724873624426
479,The Conjuring: The Devil Made Me Do It,206431050,65631050,140800000,2021.csv,2021,0.31793206496793963,0.6820679350320603
480,Raging Fire,205842393,385305,205457088,2021.csv,2021,0.0018718447370556948,0.9981281552629443
481,London Has Fallen,205754447,62524260,143230187,2016.csv,2016,0.30387804935268303,0.696121950647317
482,Journey to the West,205637183,18058,205619125,2013.csv,2013,8.781485788005567e-05,0.99991218514212
483,White House Down,205366737,73103784,132262953,2013.csv,2013,0.35596701329485503,0.644032986705145
484,Birds of Prey,205358461,84158461,121200000,2020.csv,2020,0.4098124839375379,0.5901875160624621
485,A Dog's Purpose,205035819,64508620,140527199,2017.csv,2017,0.3146212223533489,0.6853787776466511
486,Fun with Dick and Jane,204681899,110332737,94349162,2005.csv,2005,0.5390449157402043,0.46095508425979576
487,Ghostbusters: Afterlife,204334455,129360575,74973880,2021.csv,2021,0.6330825361782476,0.36691746382175244
488,King Arthur,203567857,51882244,151685613,2004.csv,2004,0.2548646174528428,0.7451353825471573
489,Everest,203427584,43482270,159945314,2015.csv,2015,0.2137481512831613,0.7862518487168387
490,Vanilla Sky,203388341,100618344,102769997,2001.csv,2001,0.4947104809709815,0.5052895190290185
491,Arrival,203388186,100546139,102842047,2016.csv,2016,0.49435584719753584,0.5056441528024641
492,Need for Speed,203277636,43577636,159700000,2014.csv,2014,0.2143749644943726,0.7856250355056273
493,Garfield,203172417,75369589,127802828,2004.csv,2004,0.3709636874576336,0.6290363125423665
494,The Addams Family,203044905,100044905,103000000,2019.csv,2019,0.49272305059809307,0.5072769494019069
495,Straight Outta Compton,201634991,161197785,40437206,2015.csv,2015,0.7994534291917617,0.20054657080823834
496,Cats & Dogs,200687492,93385515,107301977,2001.csv,2001,0.46532802851510047,0.5346719714848995
497,Percy Jackson: Sea of Monsters,199850315,68559554,131290761,2013.csv,2013,0.34305452057956476,0.6569454794204352
498,Two Weeks Notice,199043242,93354851,105688391,2002.csv,2002,0.469017938323171,0.530982061676829
499,Shock Wave 2,198921659,0,198921659,2020.csv,2020,0.0,1.0
500,The Pacifier,198636868,113086868,85550000,2005.csv,2005,0.5693145947105851,0.43068540528941485
501,50 First Dates,198413428,120908074,77505354,2004.csv,2004,0.6093744522170143,0.39062554778298575
502,The Island,198326350,670883,197655467,2018.csv,2018,0.0033827224672868736,0.9966172775327131
503,Christopher Robin,197744377,99215042,98529335,2018.csv,2018,0.5017338217409844,0.4982661782590157
504,Jack the Giant Slayer,197687603,65187603,132500000,2013.csv,2013,0.3297505863329225,0.6702494136670776
505,Smurfs: The Lost Village,197183546,45020282,152163264,2017.csv,2017,0.22831662637814618,0.7716833736218538
506,Chinese Doctors,197143218,0,197143218,2021.csv,2021,0.0,1.0
507,Spy Kids 3: Game Over,197011982,111761982,85250000,2003.csv,2003,0.567285201973147,0.43271479802685303
508,The Other Woman,196710396,83911193,112799203,2014.csv,2014,0.4265722336301941,0.5734277663698059
509,Panic Room,196397415,96397334,100000081,2002.csv,2002,0.49082791644686363,0.5091720835531364
510,Anger Management,195745823,135645823,60100000,2003.csv,2003,0.6929691827957933,0.3070308172042067
511,The Shape of Water,195333312,63859435,131473877,2017.csv,2017,0.3269254708587545,0.6730745291412455
512,Rocketman,195320400,96368160,98952240,2019.csv,2019,0.4933850227625993,0.5066149772374007
513,The BFG,195243411,55483770,139759641,2016.csv,2016,0.28417742609506036,0.7158225739049396
514,Downton Abbey,194694725,96853865,97840860,2019.csv,2019,0.49746527544595776,0.5025347245540422
515,The Intern,194564672,75764672,118800000,2015.csv,2015,0.38940610965591943,0.6105938903440805
516,Wallace & Gromit: The Curse of the Were-Rabbit,194111171,56110897,138000274,2005.csv,2005,0.2890657797329964,0.7109342202670036
517,The Sum of All Fears,193921372,118907036,75014336,2002.csv,2002,0.6131713837090633,0.38682861629093673
518,Gangs of New York,193772504,77812000,115960504,2002.csv,2002,0.4015636810886234,0.5984363189113766
519,The Monkey King 2,193678298,709982,192968316,2016.csv,2016,0.003665779838689,0.996334220161311
520,Weathering with You,193136313,8056636,185079677,2019.csv,2019,0.041714765467227286,0.9582852345327727
521,The Lost City,192907684,105344029,87563655,2022.csv,2022,0.5460851886024405,0.45391481139755946
522,The Equalizer,192330738,101530738,90800000,2014.csv,2014,0.527896575741315,0.47210342425868507
523,The Lego Movie 2: The Second Part,192306508,105806508,86500000,2019.csv,2019,0.5501972299346208,0.44980277006537916
524,Sheep Without a Shepherd,191602146,0,191602146,2019.csv,2019,0.0,1.0
525,The Longest Yard,191466556,158119460,33347096,2005.csv,2005,0.8258333115888918,0.17416668841110822
526,The Equalizer 2,190400157,102084362,88315795,2018.csv,2018,0.5361569213411941,0.4638430786588059
527,Hollow Man,190213455,73209340,117004115,2000.csv,2000,0.3848799234523131,0.615120076547687
528,Cheaper by the Dozen,190212113,138614544,51597569,2003.csv,2003,0.7287366814541406,0.2712633185458594
529,The White Storm 2: Drug Lords,189396380,609461,188786919,2019.csv,2019,0.003217912612690908,0.9967820873873091
530,Breakup Buddies,189017596,777896,188239700,2014.csv,2014,0.004115468699538428,0.9958845313004616
531,Abominable,188623517,60716390,127907127,2019.csv,2019,0.32189194097149615,0.6781080590285039
532,The Secret Life of Walter Mitty,188133322,58236838,129896484,2013.csv,2013,0.30955089391341317,0.6904491060865868
533,Project Gutenberg,188116796,0,188116796,2018.csv,2018,0.0,1.0
534,12 Years a Slave,187733202,56671993,131061209,2013.csv,2013,0.30187517389704993,0.6981248261029501
535,The Grudge,187281115,110359362,76921753,2004.csv,2004,0.5892711713084365,0.41072882869156346
536,One Piece Film: Red,187170704,12775324,174395380,2022.csv,2022,0.06825493374219505,0.931745066257805
537,Walk the Line,186797986,119519402,67278584,2005.csv,2005,0.6398323909123945,0.3601676090876055
538,Jian Bing Man,186683536,0,186683536,2015.csv,2015,0.0,1.0
539,Atlantis: The Lost Empire,186053725,84056472,101997253,2001.csv,2001,0.45178602040888993,0.5482139795911101
540,Pitch Perfect 3,185400345,104897530,80502815,2017.csv,2017,0.5657892923554161,0.4342107076445839
541,Bad Moms,183936074,113257297,70678777,2016.csv,2016,0.615742711785835,0.3842572882141651
542,Jupiter Ascending,183887723,47387723,136500000,2015.csv,2015,0.25769922117095334,0.7423007788290467
543,102 Dalmatians,183611771,66957026,116654745,2000.csv,2000,0.36466630453665194,0.6353336954633481
544,Stand by Me Doraemon,183442714,0,183442714,2014.csv,2014,0.0,1.0
545,The Hitman's Bodyguard,183415183,75468583,107946600,2017.csv,2017,0.41146311753264175,0.5885368824673582
546,Storks,183388953,72679278,110709675,2016.csv,2016,0.3963121922616571,0.6036878077383429
547,Insidious: The Red Door,182430087,80630087,101800000,2023.csv,2023,0.4419780110064849,0.5580219889935151
548,The Haunted Mansion,182290266,75847266,106443000,2003.csv,2003,0.41607962764177436,0.5839203723582257
549,From Vegas to Macau III,181732879,0,181732879,2016.csv,2016,0.0,1.0
550,Cliff Walkers,181325565,152972,181172593,2021.csv,2021,0.0008436317294806168,0.9991563682705193
551,Scooby-Doo 2: Monsters Unleashed,181216833,84216833,97000000,2004.csv,2004,0.46472963689857666,0.5352703631014234
552,Road to Perdition,181001478,104454762,76546716,2002.csv,2002,0.5770934201984804,0.42290657980151963
553,Kill Bill: Vol. 1,180899045,70099045,110800000,2003.csv,2003,0.38750367642902706,0.612496323570973
554,Sweet Home Alabama,180622424,127223418,53399006,2002.csv,2002,0.7043611484252918,0.29563885157470815
555,Daddy's Home 2,180613180,104029443,76583737,2017.csv,2017,0.5759792447040687,0.42402075529593136
556,Hacksaw Ridge,180563636,67209615,113354021,2016.csv,2016,0.37222120959061766,0.6277787904093823
557,M3gan,179949165,95043350,84905815,2022.csv,2022,0.5281677744934243,0.4718322255065757
558,The Post,179769457,81903458,97865999,2017.csv,2017,0.4556027445752367,0.5443972554247632
559,The League of Extraordinary Gentlemen,179265204,66465204,112800000,2003.csv,2003,0.37076466886457227,0.6292353311354277
560,Allegiant,179246868,66184051,113062817,2016.csv,2016,0.36923407219589466,0.6307659278041053
561,Moulin Rouge!,179213434,57386607,121826827,2001.csv,2001,0.320213756966456,0.6797862430335441
562,Daredevil,179179718,102543518,76636200,2003.csv,2003,0.5722942258453605,0.4277057741546395
563,The Scorpion King,178799308,91047077,87752231,2002.csv,2002,0.5092138108275005,0.4907861891724995
564,Along Came Polly,178311729,88097164,90214565,2004.csv,2004,0.4940626423963395,0.5059373576036605
565,Brokeback Mountain,178062759,83043761,95018998,2005.csv,2005,0.46637354978870116,0.5336264502112988
566,Baywatch,177856751,58060186,119796565,2017.csv,2017,0.32644353207599075,0.6735564679240093
567,How to Lose a Guy in 10 Days,177502387,105813373,71689014,2003.csv,2003,0.5961236622693981,0.4038763377306019
568,Alien vs. Predator,177427090,80282231,97144859,2004.csv,2004,0.4524801201439983,0.5475198798560017
569,Hero,177395557,53710019,123685538,2002.csv,2002,0.302769809505432,0.697230190494568
570,The 40-Year-Old Virgin,177378645,109449237,67929408,2005.csv,2005,0.6170372820245639,0.38296271797543613
571,The Butler,177313795,116632095,60681700,2013.csv,2013,0.6577722562421046,0.34222774375789544
572,Suzume,176408037,10760901,165647136,2022.csv,2022,0.06100006089858593,0.9389999391014141
573,Serial Bad Weddings,176404493,0,176404493,2014.csv,2014,0.0,1.0
574,Ip Man 4: The Finale,176345966,3956031,172389935,2019.csv,2019,0.02243335126815433,0.9775666487318456
575,Dr. Dolittle 2,176104344,112952899,63151445,2001.csv,2001,0.6413975739292382,0.35860242607076176
576,The Italian Job,176070171,106128601,69941570,2003.csv,2003,0.6027630938121824,0.3972369061878176
577,The Monkey King: Havoc in Heaven's Palace,175835580,0,175835580,2014.csv,2014,0.0,1.0
578,The Mule,174804407,103804407,71000000,2018.csv,2018,0.5938317504775494,0.40616824952245056
579,Identity Thief,173965010,134506920,39458090,2013.csv,2013,0.7731837568945618,0.22681624310543827
580,The Nutcracker and the Four Realms,173961069,54858851,119102218,2018.csv,2018,0.3153513100106323,0.6846486899893677
581,Big Momma's House,173959438,117559438,56400000,2000.csv,2000,0.6757864899517553,0.32421351004824467
582,Amélie,173921954,33225499,140696455,2001.csv,2001,0.1910368313824257,0.8089631686175743
583,Operation Mekong,173839072,800012,173039060,2016.csv,2016,0.004602026407504062,0.9953979735924959
584,Creed,173567581,109767581,63800000,2015.csv,2015,0.6324198353608442,0.3675801646391557
585,Gemini Man,173469516,48546770,124922746,2019.csv,2019,0.27985764369112553,0.7201423563088745
586,The Girl on the Train,173185859,75395035,97790824,2016.csv,2016,0.435341750390833,0.564658249609167
587,Cold Mountain,173013509,95636509,77377000,2003.csv,2003,0.5527690268394013,0.4472309731605987
588,Black Hawk Down,172989651,108638745,64350906,2001.csv,2001,0.6280071921759065,0.3719928078240935
589,The Grand Budapest Hotel,172936941,59301324,113635617,2014.csv,2014,0.342907210322403,0.657092789677597
590,The Santa Clause 2,172855065,139236327,33618738,2002.csv,2002,0.8055090951485859,0.1944909048514141
591,Spies in Disguise,171616764,66757013,104859751,2019.csv,2019,0.3889888810629246,0.6110111189370754
592,John Wick: Chapter 2,171539887,92029184,79510703,2017.csv,2017,0.5364885427492441,0.46351145725075593
593,Anchorman 2: The Legend Continues,171464676,125168368,46296308,2013.csv,2013,0.7299950690718361,0.2700049309281639
594,Mr. Deeds,171269535,126293452,44976083,2002.csv,2002,0.7373958947223159,0.2626041052776841
595,Nope,171235592,123277080,47958512,2022.csv,2022,0.7199267311202452,0.28007326887975487
596,Olympus Has Fallen,170270201,98925640,71344561,2013.csv,2013,0.5809920903305916,0.4190079096694083
597,Starsky & Hutch,170268750,88237754,82030996,2004.csv,2004,0.5182263568623132,0.4817736431376867
598,Shall We Dance,170128460,57890460,112238000,2004.csv,2004,0.3402749898517861,0.6597250101482138
599,Stuart Little 2,169956806,64956806,105000000,2002.csv,2002,0.3821959680743824,0.6178040319256176
600,Dumb and Dumber To,169837010,86208010,83629000,2014.csv,2014,0.5075926030492411,0.49240739695075886
601,Ghost in the Shell,169801921,40563557,129238364,2017.csv,2017,0.23888750351652382,0.7611124964834762
602,Wonder Woman 1984,169601036,46801036,122800000,2020.csv,2020,0.2759478190923315,0.7240521809076685
603,The Emperor's New Groove,169327687,89302687,80025000,2000.csv,2000,0.5273956585729539,0.4726043414270461
604,Scream VI,168961389,108161389,60800000,2023.csv,2023,0.6401544733986533,0.3598455266013468
605,The Suicide Squad,168717425,55817425,112900000,2021.csv,2021,0.33083378910032557,0.6691662108996744
606,Ticket to Paradise,168627607,68275985,100351622,2022.csv,2022,0.40489209456669806,0.5951079054333019
607,Dodgeball: A True Underdog Story,168423227,114326736,54096491,2004.csv,2004,0.6788062313994256,0.3211937686005743
608,Insidious: The Last Key,167885588,67745330,100140258,2018.csv,2018,0.40352081919026905,0.596479180809731
609,Fantastic Four,167882881,56117548,111765333,2015.csv,2015,0.3342660530110869,0.6657339469889131
610,Morbius,167460961,73865530,93595431,2022.csv,2022,0.4410910433029224,0.5589089566970776
611,Alexander,167298192,34297191,133001001,2004.csv,2004,0.20500634579481888,0.7949936542051811
612,Jujutsu Kaisen 0,166760828,34542754,132218074,2021.csv,2021,0.2071394968127647,0.7928605031872353
613,Nutty Professor II: The Klumps,166339890,123309890,43030000,2000.csv,2000,0.7413128023590734,0.2586871976409267
614,RRR,165955146,14500000,151455146,2022.csv,2022,0.0873730061977108,0.9126269938022892
615,Bridge of Spies,165478348,72313754,93164594,2015.csv,2015,0.4369982833041094,0.5630017166958906
616,The Princess Diaries,165335153,108248956,57086197,2001.csv,2001,0.6547243827814403,0.3452756172185597
617,The Huntsman: Winter's War,164989338,48390190,116599148,2016.csv,2016,0.2932928308373478,0.7067071691626522
618,Bringing Down the House,164729679,132716677,32013002,2003.csv,2003,0.8056634226792854,0.19433657732071463
619,Daddy Day Care,164433867,104297061,60136806,2003.csv,2003,0.6342796827857853,0.3657203172142148
620,The Ring Two,163995949,76231249,87764700,2005.csv,2005,0.46483617104468844,0.5351638289553116
621,From Vegas to Macau II,163877532,0,163877532,2015.csv,2015,0.0,1.0
622,Space Jam: A New Legacy,163692228,70592228,93100000,2021.csv,2021,0.4312497231084178,0.5687502768915822
623,Sound of Freedom,163472260,163472260,0,2023.csv,2023,1.0,0.0
624,The Island,162949164,35818913,127130251,2005.csv,2005,0.21981648828833514,0.7801835117116649
625,The Interpreter,162944923,72708161,90236762,2005.csv,2005,0.4462131109172392,0.5537868890827609
626,The Magnificent Seven,162360636,93432655,68927981,2016.csv,2016,0.5754637164638847,0.4245362835361152
627,Memoirs of a Geisha,162242962,57490508,104752454,2005.csv,2005,0.35434823977141144,0.6456517602285885
628,Jack Reacher: Never Go Back,162146076,58697076,103449000,2016.csv,2016,0.36200121179620776,0.6379987882037922
629,Insidious: Chapter 2,161919318,83586447,78332871,2013.csv,2013,0.5162228203060983,0.4837771796939016
630,Scream 3,161834276,89143175,72691101,2000.csv,2000,0.5508300046400554,0.4491699953599446
631,Into the Storm,161502194,47602194,113900000,2014.csv,2014,0.29474642307336085,0.7052535769266391
632,Unbroken,161459297,115637895,45821402,2014.csv,2014,0.7162046233856698,0.28379537661433024
633,The Black Phone,161440742,90123230,71317512,2022.csv,2022,0.5582434079744257,0.4417565920255743
634,The Sacrifice,161047608,0,161047608,2020.csv,2020,0.0,1.0
635,Freaky Friday,160846332,110230332,50616000,2003.csv,2003,0.6853145522771387,0.31468544772286133
636,The Predator,160542134,51024708,109517426,2018.csv,2018,0.3178275181018835,0.6821724818981165
637,Johnny English,160466000,28082366,132383634,2003.csv,2003,0.1750050851893859,0.824994914810614
638,"Three Billboards Outside Ebbing, Missouri",160192031,54513740,105678291,2017.csv,2017,0.3403024461310438,0.6596975538689562
639,Lara Croft: Tomb Raider - The Cradle of Life,160099222,65660196,94439026,2003.csv,2003,0.41012189303455826,0.5898781069654417
640,Johnny English Strikes Again,158970776,4412170,154558606,2018.csv,2018,0.02775459811556811,0.9722454018844319
641,Focus,158762963,53862963,104900000,2015.csv,2015,0.3392665517334795,0.6607334482665205
642,Sin City,158733820,74103820,84630000,2005.csv,2005,0.4668432977924931,0.5331567022075069
643,Goosebumps,158260952,80080379,78180573,2015.csv,2015,0.5060021312142745,0.4939978687857255
644,Don't Breathe,157761002,89217875,68543127,2016.csv,2016,0.5655255346311758,0.43447446536882417
645,Hustlers,157563598,104963598,52600000,2019.csv,2019,0.6661665469203109,0.33383345307968915
646,The Matrix Resurrections,157286805,37686805,119600000,2021.csv,2021,0.23960563634056906,0.7603943636594309
647,Ip Man 3,156954938,2679437,154275501,2015.csv,2015,0.01707137751855886,0.9829286224814411
648,The Climbers,156892866,487157,156405709,2019.csv,2019,0.0031050296448788183,0.9968949703551212
649,Mystic River,156595191,90135191,66460000,2003.csv,2003,0.5755936081076717,0.4244063918923283
650,The Hateful Eight,155760117,54117416,101642701,2015.csv,2015,0.3474407765114866,0.6525592234885135
651,Escape Room,155712077,57005601,98706476,2019.csv,2019,0.36609620845273294,0.6339037915472671
652,The Monuments Men,155641650,78031620,77610030,2014.csv,2014,0.5013543611237737,0.49864563887622626
653,Monster-in-Law,155457327,82931301,72526026,2005.csv,2005,0.5334666599535705,0.4665333400464296
654,The Accountant,155160045,86260045,68900000,2016.csv,2016,0.5559423819450426,0.44405761805495736
655,Bayside Shakedown 2,155138312,0,155138312,2003.csv,2003,0.0,1.0
656,Blade II,155010032,82348319,72661713,2002.csv,2002,0.5312450938659248,0.4687549061340752
657,Maid in Manhattan,154906693,94011225,60895468,2002.csv,2002,0.6068893679113013,0.39311063208869873
658,Lone Survivor,154802912,125095601,29707311,2013.csv,2013,0.8080959161801814,0.19190408381981858
659,The Phantom of the Opera,154648887,51268815,103380072,2004.csv,2004,0.331517516837997,0.668482483162003
660,Yesterday,154608856,73286650,81322206,2019.csv,2019,0.47401327385799946,0.5259867261420006
661,Ride Along,154468902,134938200,19530702,2014.csv,2014,0.8735622397315933,0.12643776026840664
662,Kill Bill: Vol. 2,154116796,66208183,87908613,2004.csv,2004,0.4295974528305143,0.5704025471694857
663,Peter Rabbit 2: The Runaway,153901717,40501717,113400000,2021.csv,2021,0.2631661152942173,0.7368338847057827
664,House of Gucci,153269161,53809574,99459587,2021.csv,2021,0.35107893622514186,0.6489210637748581
665,Monkey King: Hero Is Back,153262397,0,153262397,2015.csv,2015,0.0,1.0
666,Duckweed,152894264,471575,152422689,2017.csv,2017,0.0030843210704098096,0.9969156789295902
667,Chocolat,152699946,71509363,81190583,2000.csv,2000,0.4682998578139641,0.5317001421860359
668,The First Slam Dunk,152053119,1050647,151002472,2022.csv,2022,0.006909736590145185,0.9930902634098548
669,Jackass Presents: Bad Grandpa,151826547,102003019,49823528,2013.csv,2013,0.6718391547164674,0.3281608452835327
670,47 Ronin,151783839,38362475,113421364,2013.csv,2013,0.25274413437388416,0.7472558656261158
671,Red Sparrow,151572634,46874505,104698129,2018.csv,2018,0.30925440670246584,0.6907455932975342
672,Darkest Hour,150847207,56468410,94378797,2017.csv,2017,0.37434176689794463,0.6256582331020554
673,Gods of Egypt,150680864,31153464,119527400,2015.csv,2015,0.20675129656808977,0.7932487034319102
674,A Writer's Odyssey,150123320,160013,149963307,2021.csv,2021,0.001065877040289277,0.9989341229597107
675,"Me, Myself & Irene",149270999,90570999,58700000,2000.csv,2000,0.606755495754403,0.393244504245597
676,Lights Out,148868835,67268835,81600000,2016.csv,2016,0.4518664702387172,0.5481335297612828
677,King Arthur: Legend of the Sword,148675066,39175066,109500000,2017.csv,2017,0.2634945257061463,0.7365054742938537
678,Seabiscuit,148336445,120277854,28058591,2003.csv,2003,0.8108449275564074,0.18915507244359267
679,RED 2,148075565,53262560,94813005,2013.csv,2013,0.35969850933879605,0.640301490661204
680,Spy Kids,147934180,112719001,35215179,2001.csv,2001,0.7619537351002993,0.23804626489970065
681,The Mexican,147845033,66845033,81000000,2001.csv,2001,0.4521290410885836,0.5478709589114164
682,The Angry Birds Movie 2,147792047,41667116,106124931,2019.csv,2019,0.2819307049722371,0.7180692950277628
683,Saw II,147748505,87039965,60708540,2005.csv,2005,0.5891089388687892,0.41089106113121077
684,Swordfish,147080413,69772969,77307444,2001.csv,2001,0.4743865452703073,0.5256134547296927
685,Planes: Fire & Rescue,146965787,59165787,87800000,2014.csv,2014,0.402582044486313,0.597417955513687
686,The Last Witch Hunter,146936910,27367660,119569250,2015.csv,2015,0.18625449521158435,0.8137455047884157
687,The Boss Baby 2: Family Business,146745280,57300280,89445000,2021.csv,2021,0.3904744329766518,0.6095255670233483
688,Evil Dead Rise,146733054,67233054,79500000,2023.csv,2023,0.4581997863957769,0.541800213604223
689,Angel Has Fallen,146661977,69030436,77631541,2019.csv,2019,0.470677113537069,0.529322886462931
690,Mama,146428180,71628180,74800000,2013.csv,2013,0.4891693661698179,0.5108306338301821
691,Time Raiders,145819137,0,145819137,2016.csv,2016,0.0,1.0
692,The Foreigner,145374099,34393507,110980592,2017.csv,2017,0.23658620921186244,0.7634137907881375
693,Home on the Range,145358062,50030461,95327601,2004.csv,2004,0.344187727268956,0.655812272731044
694,The Exorcism of Emily Rose,145166804,75072454,70094350,2005.csv,2005,0.5171461514024929,0.4828538485975072
695,The Invisible Man,144492724,70410000,74082724,2020.csv,2020,0.4872909725198343,0.5127090274801657
696,Where the Crawdads Sing,144353965,90230760,54123205,2022.csv,2022,0.6250660312655769,0.37493396873442303
697,PAW Patrol: The Movie,144327371,40127371,104200000,2021.csv,2021,0.27803022200134164,0.7219697779986584
698,Herbie Fully Loaded,144146816,66023816,78123000,2005.csv,2005,0.4580317334237893,0.5419682665762108
699,The Beach,144056873,39785027,104271846,2000.csv,2000,0.2761758336931276,0.7238241663068724
700,Pete's Dragon,143695338,76233151,67462187,2016.csv,2016,0.5305193060612725,0.4694806939387275
701,Spy Game,143049560,62362560,80687000,2001.csv,2001,0.435950729243767,0.564049270756233
702,More Than Blue,142958164,722669,142235495,2018.csv,2018,0.005055108290282743,0.9949448917097172
703,The Legend of Zorro,142400065,46464023,95936042,2005.csv,2005,0.32629214740878104,0.673707852591219
704,Power Rangers,142337240,85364450,56972790,2017.csv,2017,0.5997337731151735,0.4002662268848265
705,Meg 2: The Trench,142000000,30000000,112000000,2023.csv,2023,0.2112676056338028,0.7887323943661971
706,Onward,141940042,61555145,80384897,2020.csv,2020,0.43367004921697855,0.5663299507830215
707,Legally Blonde,141774679,96520674,45254005,2001.csv,2001,0.6808033330126602,0.31919666698733984
708,The Taking of Tiger Mountain,141654055,228984,141425071,2014.csv,2014,0.0016165015537324364,0.9983834984462676
709,Gothika,141591324,59694580,81896744,2003.csv,2003,0.42159772444814486,0.5784022755518552
710,Mona Lisa Smile,141337989,63860942,77477047,2003.csv,2003,0.4518314039405216,0.5481685960594784
711,Scary Movie 2,141220678,71308997,69911681,2001.csv,2001,0.5049472783298774,0.49505272167012254
712,Shallow Hal,141069860,70839203,70230657,2001.csv,2001,0.5021568958812321,0.4978431041187678
713,Trainwreck,140795793,110212700,30583093,2015.csv,2015,0.7827840424180856,0.2172159575819144
714,Sausage Party,140705322,97685686,43019636,2016.csv,2016,0.6942572221966131,0.3057427778033869
715,Girls Trip,140552359,115171585,25380774,2017.csv,2017,0.8194212165446473,0.18057878345535275
716,Lion,140312928,51738905,88574023,2016.csv,2016,0.3687394008341127,0.6312605991658873
717,The SpongeBob SquarePants Movie,140192993,85417988,54775005,2004.csv,2004,0.6092885683666087,0.3907114316333913
718,Everything Everywhere All at Once,139474528,77191785,62282743,2022.csv,2022,0.5534471857112147,0.4465528142887854
719,Mr. Six,139191345,1415450,137775895,2015.csv,2015,0.010169094924688026,0.989830905075312
720,The Admiral: Roaring Currents,138342258,2589811,135752447,2014.csv,2014,0.018720317547513212,0.9812796824524868
721,America's Sweethearts,138307673,93607673,44700000,2001.csv,2001,0.676807518842429,0.32319248115757104
722,Let's Be Cops,138224951,82390774,55834177,2014.csv,2014,0.5960629640592168,0.40393703594078323
723,Scream,137743924,81641405,56102519,2022.csv,2022,0.5927042197520088,0.4072957802479912
724,Escape Plan,137328301,25135965,112192336,2013.csv,2013,0.18303557836923942,0.8169644216307606
725,Death on the Nile,137307235,45630104,91677131,2022.csv,2022,0.3323211919604965,0.6676788080395035
726,The First Purge,137056262,69488745,67567517,2018.csv,2018,0.5070089026650968,0.49299109733490326
727,Annie,136853506,85911262,50942244,2014.csv,2014,0.6277607677804031,0.3722392322195969
728,How Long Will I Love U,136796719,746933,136049786,2018.csv,2018,0.005460167505918033,0.994539832494082
729,Remember the Titans,136706683,115654751,21051932,2000.csv,2000,0.8460065628247304,0.15399343717526962
730,Skiptrace,136579287,0,136579287,2016.csv,2016,0.0,1.0
731,Tom & Jerry,136536687,46536687,90000000,2021.csv,2021,0.34083650352523936,0.6591634964747607
732,The Jungle Book 2,135703599,47901582,87802017,2003.csv,2003,0.35298682093169836,0.6470131790683017
733,Jack Ryan: Shadow Recruit,135503748,50577412,84926336,2014.csv,2014,0.3732547087922616,0.6267452912077384
734,American Made,134866593,51342000,83524593,2017.csv,2017,0.3806873063072039,0.6193126936927961
735,The Princess Diaries 2: Royal Engagement,134734481,95170481,39564000,2004.csv,2004,0.7063557917293644,0.29364420827063564
736,The Cat in the Hat,133960541,101149285,32811256,2003.csv,2003,0.7550677553623795,0.24493224463762056
737,Pokémon the Movie 2000,133949270,43758684,90190586,2000.csv,2000,0.32668101886632156,0.6733189811336785
738,Shazam! Fury of the Gods,133838006,57638006,76200000,2023.csv,2023,0.43065499645892813,0.5693450035410719
739,Point Break,133718711,28782481,104936230,2015.csv,2015,0.21524647362178057,0.7847535263782194
740,The Big Short,133440870,70259870,63181000,2015.csv,2015,0.5265243699325401,0.47347563006745985
741,A Wrinkle in Time,132675864,100478608,32197256,2018.csv,2018,0.7573239394921144,0.2426760605078856
742,Be Somebody,132326332,0,132326332,2021.csv,2021,0.0,1.0
743,2 Guns,131940411,75612460,56327951,2013.csv,2013,0.5730803733815867,0.4269196266184134
744,Blade: Trinity,131883935,52411906,79472029,2004.csv,2004,0.39740932813386254,0.6025906718661375
745,Save the Last Dance,131706809,91057006,40649803,2001.csv,2001,0.6913614162499374,0.3086385837500626
746,Halloween Kills,131647155,92002155,39645000,2021.csv,2021,0.6988541074055113,0.30114589259448865
747,The House with a Clock in Its Walls,131457147,68549695,62907452,2018.csv,2018,0.521460388912898,0.478539611087102
748,Bewitched,131426169,63313159,68113010,2005.csv,2005,0.4817393634900824,0.5182606365099176
749,School of Rock,131095614,81261177,49834437,2003.csv,2003,0.6198619047621227,0.3801380952378773
750,Munich,130982129,47403685,83578444,2005.csv,2005,0.36190956248695577,0.6380904375130443
751,Man on Fire,130834852,77911774,52923078,2004.csv,2004,0.595497092777695,0.404502907222305
752,A Bad Moms Christmas,130560428,72110659,58449769,2017.csv,2017,0.5523163496369665,0.4476836503630334
753,About a Boy,130549455,41385278,89164177,2002.csv,2002,0.317008431785487,0.682991568214513
754,Raya and the Last Dragon,130423032,54723032,75700000,2021.csv,2021,0.4195810445504748,0.5804189554495252
755,Cheaper by the Dozen 2,130154568,82571173,47583395,2005.csv,2005,0.6344085672044949,0.3655914327955051
756,Mean Girls,130125829,86058055,44067774,2004.csv,2004,0.6613449125461479,0.3386550874538521
757,Resident Evil: Apocalypse,129342769,51201453,78141316,2004.csv,2004,0.3958586428592695,0.6041413571407305
758,Warm Hug,129240236,0,129240236,2020.csv,2020,0.0,1.0
759,Space Cowboys,128884132,90464773,38419359,2000.csv,2000,0.70190776472002,0.29809223527998
760,Pathaan,128780000,17487476,95096840,2023.csv,2023,0.13579341512657245,0.7384441683491225
761,Pan,128388320,35088320,93300000,2015.csv,2015,0.2732983810365304,0.7267016189634695
762,Space Station 3D,128363881,93383953,34979928,2002.csv,2002,0.7274939980974866,0.2725060019025134
763,Sister,128317206,0,128317206,2021.csv,2021,0.0,1.0
764,Blended,127994610,46294610,81700000,2014.csv,2014,0.36169187124364066,0.6383081287563593
765,U-571,127666415,77122415,50544000,2000.csv,2000,0.6040932143351875,0.39590678566481247
766,Ad Astra,127461872,50188370,77273502,2019.csv,2019,0.393752023350167,0.606247976649833
767,Midway,127420861,56846802,70574059,2019.csv,2019,0.4461341852022174,0.5538658147977826
768,March of the Penguins,127392693,77437223,49955470,2005.csv,2005,0.60786235989218,0.39213764010782
769,Sex Tape,126069509,38543473,87526036,2014.csv,2014,0.30573191968249835,0.6942680803175016
770,This Is the End,126041322,101470202,24571120,2013.csv,2013,0.8050550437736602,0.1949449562263398
771,The King's Man,125897478,37176373,88721105,2021.csv,2021,0.29529084768481223,0.7047091523151877
772,The Upside,125852517,108252517,17600000,2019.csv,2019,0.860153770305603,0.13984622969439697
773,Detective Chinatown,125842935,474252,125368683,2015.csv,2015,0.003768602504383738,0.9962313974956163
774,Wolf Totem,125837070,210591,125626479,2015.csv,2015,0.0016735211651065938,0.9983264788348934
775,Mechanic: Resurrection,125729635,21218403,104511232,2016.csv,2016,0.1687621458536804,0.8312378541463196
776,Ender's Game,125544024,61737191,63806833,2013.csv,2013,0.49175730578780874,0.5082426942121913
777,Happy Death Day,125479266,55683845,69795421,2017.csv,2017,0.44376929173302626,0.5562307082669737
778,Captain Underpants: The First Epic Movie,125427681,73921000,51506681,2017.csv,2017,0.5893515642691345,0.4106484357308655
779,"Legally Blonde 2: Red, White & Blonde",124914842,90186328,34728514,2003.csv,2003,0.7219824846754399,0.2780175153245601
780,The Family Man,124745083,75793305,48951778,2000.csv,2000,0.6075855110056723,0.39241448899432774
781,Ride Along 2,124605297,91221830,33383467,2015.csv,2015,0.7320862932496361,0.2679137067503639
782,Ray,123971376,75331600,48639776,2004.csv,2004,0.6076531731002163,0.39234682689978373
783,The Time Machine,123729176,56832494,66896682,2002.csv,2002,0.4593297703687932,0.5406702296312068
784,The Theory of Everything,123726688,35893537,87833151,2014.csv,2014,0.2901034334645731,0.7098965665354269
785,Last Christmas,123446172,35150750,88295422,2019.csv,2019,0.28474556505486454,0.7152544349451354
786,Nanny McPhee,123276807,47144110,76132697,2005.csv,2005,0.3824248141014879,0.6175751858985121
787,Big Fish,123218424,66809693,56408731,2003.csv,2003,0.5422053848051165,0.4577946151948835
788,Hide and Seek,123204920,51100486,72104434,2005.csv,2005,0.41476010860605245,0.5852398913939476
789,The Curse of La Llorona,123133739,54733739,68400000,2019.csv,2019,0.4445064321485438,0.5554935678514562
790,The Lego Ninjago Movie,123081555,59281555,63800000,2017.csv,2017,0.4816445079849698,0.5183554920150302
791,Looking Up,122994583,84267,122910316,2019.csv,2019,0.0006851277344466463,0.9993148722655534
792,Zombieland: Double Tap,122810399,73123082,49687317,2019.csv,2019,0.5954144160056023,0.40458558399439776
793,Dragon Blade,122593849,74068,122519781,2015.csv,2015,0.0006041738684621934,0.9993958261315378
794,Spirit: Stallion of the Cimarron,122563539,73280117,49283422,2002.csv,2002,0.5978949171825073,0.40210508281749274
795,Prisoners,122126687,61002302,61124385,2013.csv,2013,0.4995001788593512,0.5004998211406488
796,Secret Superstar,122026260,0,122026260,2017.csv,2017,0.0,1.0
797,Peter Pan,121975011,48462608,73512403,2003.csv,2003,0.3973158731668407,0.6026841268331593
798,Deepwater Horizon,121790373,61433527,60356846,2016.csv,2016,0.5044202221139433,0.4955797778860567
799,Pride & Prejudice,121616555,38405088,83211467,2005.csv,2005,0.31578832339067653,0.6842116766093235
800,Soul,120957731,0,120957731,2020.csv,2020,0.0,1.0
801,The Nut Job,120885527,64251541,56633986,2014.csv,2014,0.531507307735855,0.4684926922641451
802,Intolerable Cruelty,120801243,35327628,85473615,2003.csv,2003,0.2924442424818427,0.7075557575181574
803,Dora and the Lost City of Gold,120597108,60477943,60119165,2019.csv,2019,0.5014875066489985,0.4985124933510014
804,Instant Family,120556201,67363237,53192964,2018.csv,2018,0.5587704028596588,0.4412295971403412
805,The Pianist,120072577,32572577,87500000,2002.csv,2002,0.27127407284679167,0.7287259271532084
806,The Commuter,119942387,36343858,83598529,2017.csv,2017,0.3030109614210029,0.6969890385789971
807,Extreme Job,119932733,1565885,118366848,2019.csv,2019,0.013056360518358236,0.9869436394816418
808,The Addams Family 2,119815153,56489153,63326000,2021.csv,2021,0.4714691888763018,0.5285308111236982
809,Road Trip,119754278,68540777,51213501,2000.csv,2000,0.5723451232364325,0.4276548767635675
810,Spy Kids 2: Island of Lost Dreams,119723358,85846429,33876929,2002.csv,2002,0.7170399363505991,0.2829600636494008
811,Wonder Park,119559110,45216793,74342317,2019.csv,2019,0.37819613244026323,0.6218038675597368
812,Allied,119520023,40098064,79421959,2016.csv,2016,0.33549243878575896,0.664507561214241
813,Sahara,119240351,68671925,50568426,2005.csv,2005,0.5759117985152526,0.4240882014847474
814,Unfaithful,119137784,52775765,66362019,2002.csv,2002,0.442980918631154,0.557019081368846
815,I Belonged to You,119107580,744541,118363039,2016.csv,2016,0.006250995948368693,0.9937490040516314
816,The Shallows,119100758,55124043,63976715,2016.csv,2016,0.46283536667331704,0.537164633326683
817,Forever Young,119055731,0,119055731,2017.csv,2017,0.0,1.0
818,Lost in Translation,118685453,44585453,74100000,2003.csv,2003,0.3756606380396088,0.6243393619603912
819,The Purge: Election Year,118587880,79213375,39374505,2016.csv,2016,0.6679719293405025,0.3320280706594974
820,Jurassic Park 2013 Re-release,118192315,45385935,72806380,2013.csv,2013,0.38400072796611184,0.6159992720338882
821,A Cool Fish,118153135,551876,117601259,2018.csv,2018,0.004670853634141828,0.9953291463658581
822,Why Him?,118102725,60323786,57778939,2016.csv,2016,0.5107738707976467,0.4892261292023533
823,Corpse Bride,118090836,53359111,64731725,2005.csv,2005,0.4518480248543587,0.5481519751456413
824,P Storm,117991727,326711,117665016,2019.csv,2019,0.0027689314183866466,0.9972310685816134
825,Saving Mr. Banks,117867984,83301580,34566404,2013.csv,2013,0.7067362753909493,0.29326372460905076
826,Pompeii,117831631,23219748,94611883,2014.csv,2014,0.19705869979852864,0.8029413002014714
827,Magic Mike XXL,117813057,66013057,51800000,2015.csv,2015,0.5603203811271954,0.43967961887280455
828,The Notebook,117812623,81001787,36810836,2004.csv,2004,0.6875476068468487,0.3124523931531513
829,Game Night,117679066,69179066,48500000,2018.csv,2018,0.5878621266419637,0.41213787335803637
830,The Forgotten,117592831,67133509,50459322,2004.csv,2004,0.5708979742140914,0.42910202578590867
831,A Knight's Tale,117487473,56569702,60917771,2001.csv,2001,0.4814956059187689,0.5185043940812311
832,Paycheck,117248958,53790451,63458507,2003.csv,2003,0.4587712498050516,0.5412287501949484
833,Warm Bodies,116980662,66380662,50600000,2013.csv,2013,0.5674498747493838,0.4325501252506162
834,Finding Neverland,116650613,51680613,64970000,2004.csv,2004,0.4430376461030685,0.5569623538969315
835,Freddy vs. Jason,116632628,82622655,34009973,2003.csv,2003,0.7084008687517527,0.29159913124824727
836,My Love,116445242,86252,116358990,2021.csv,2021,0.0007407086671690716,0.999259291332831
837,Personal Tailor,116126458,375892,115750566,2013.csv,2013,0.0032369195312923434,0.9967630804687077
838,The Chronicles of Riddick,115900534,57761012,58139522,2004.csv,2004,0.49836709121633554,0.5016329087836644
839,Dragon Ball Super: Broly,115757940,30712119,85045821,2018.csv,2018,0.26531328218176653,0.7346867178182335
840,Detective Conan: The Fist of Blue Sapphire,115570314,0,115570314,2019.csv,2019,0.0,1.0
841,Closer,115505027,33987757,81517270,2004.csv,2004,0.2942534873395597,0.7057465126604403
842,The Gentlemen,115171795,36471795,78700000,2019.csv,2019,0.31667297535824634,0.6833270246417537
843,The Monkey King 3,115084576,187074,114897502,2018.csv,2018,0.0016255349457081026,0.998374465054292
844,Snow Dogs,115035090,81172560,33862530,2002.csv,2002,0.7056330377104933,0.2943669622895066
845,So Young,114926694,11186,114915508,2013.csv,2013,9.733160861653256e-05,0.9999026683913834
846,Book of Love,114679097,0,114679097,2016.csv,2016,0.0,1.0
847,We Were Soldiers,114660784,78122718,36538066,2002.csv,2002,0.6813377274657393,0.3186622725342607
848,Office Christmas Party,114501299,54767494,59733805,2016.csv,2016,0.47831329843690246,0.5216867015630976
849,Seventh Son,114178613,17223265,96955348,2014.csv,2014,0.15084493100297164,0.8491550689970284
850,Coyote Ugly,113916474,60786269,53130205,2000.csv,2000,0.5336038490798092,0.4663961509201909
851,Insomnia,113714830,67355513,46359317,2002.csv,2002,0.5923195154053346,0.40768048459466544
852,The Score,113579918,71107711,42472207,2001.csv,2001,0.6260588337455922,0.37394116625440776
853,The Dark Tower,113231078,50701325,62529753,2017.csv,2017,0.44776863291895885,0.5522313670810411
854,Pet Sematary,113118226,54724696,58393530,2019.csv,2019,0.4837831880425706,0.5162168119574294
855,White Chicks,113086475,70831760,42254715,2004.csv,2004,0.6263504101617811,0.37364958983821894
856,Insidious: Chapter 3,112983889,52218558,60765331,2015.csv,2015,0.46217702773534375,0.5378229722646563
857,A Man Called Otto,112915441,64267657,48647784,2022.csv,2022,0.5691662400716302,0.43083375992836975
858,Final Destination,112880294,53331147,59549147,2000.csv,2000,0.47245754870199047,0.5275424512980096
859,Boonie Bears: Blast Into the Past,112367881,0,112367881,2019.csv,2019,0.0,1.0
860,How to Be Single,112343513,46843513,65500000,2016.csv,2016,0.4169667811616324,0.5830332188383677
861,The Exorcist 2000 Director's Cut,112053066,39671011,72382055,2000.csv,2000,0.3540377110252387,0.6459622889747613
862,The Purge: Anarchy,111928365,71962800,39965565,2014.csv,2014,0.6429362208587609,0.35706377914123916
863,"Dad, Where Are We Going?",111870000,0,111870000,2014.csv,2014,0.0,1.0
864,Get Hard,111711453,90411453,21300000,2015.csv,2015,0.809330203591569,0.19066979640843093
865,The Call of the Wild,111257878,62342368,48915510,2020.csv,2020,0.5603411562460323,0.4396588437539677
866,Good Boys,111173598,83140306,28033292,2019.csv,2019,0.7478421810185544,0.25215781898144557
867,The Dukes of Hazzard,111069515,80270227,30799288,2005.csv,2005,0.7227025975579348,0.27729740244206524
868,Mission to Mars,110983407,60883407,50100000,2000.csv,2000,0.5485811676334643,0.4514188323665357
869,"Lyle, Lyle, Crocodile",110979946,46888441,64091505,2022.csv,2022,0.4224947180997907,0.5775052819002092
870,Free Birds,110387072,55750480,54636592,2013.csv,2013,0.5050453734292364,0.49495462657076367
871,The Kid,110317580,69691949,40625631,2000.csv,2000,0.6317392839835682,0.36826071601643184
872,10 Cloverfield Lane,110216998,72082998,38134000,2016.csv,2016,0.6540098107190326,0.34599018928096736
873,Buddies in India,110155128,293194,109861934,2017.csv,2017,0.002661646401064506,0.9973383535989355
874,Hoodwinked,110013167,51386611,58626556,2005.csv,2005,0.46709509780770153,0.5329049021922985
875,The 5th Wave,109906372,34916787,74989585,2015.csv,2015,0.3176957474312772,0.6823042525687227
876,Return to Never Land,109862682,48430258,61432424,2002.csv,2002,0.4408253750805028,0.5591746249194972
877,Sideways,109706931,71503593,38203338,2004.csv,2004,0.6517691484779572,0.34823085152204286
878,Treasure Planet,109578115,38176783,71401332,2002.csv,2002,0.3483978803614207,0.6516021196385793
879,Along With the Gods: The Two Worlds,109383972,1908823,107475149,2017.csv,2017,0.017450664526974757,0.9825493354730253
880,Billy Elliot,109280263,21995263,87285000,2000.csv,2000,0.20127388419627065,0.7987261158037293
881,The Hours,108846072,41675994,67170078,2002.csv,2002,0.382889278723811,0.617110721276189
882,Cinderella Man,108539911,61649911,46890000,2005.csv,2005,0.5679930122662437,0.4320069877337563
883,The Boxtrolls,108255770,50837305,57418465,2014.csv,2014,0.4696036525351027,0.5303963474648973
884,Hidalgo,108040622,67303450,40737172,2004.csv,2004,0.6229457842254925,0.3770542157745075
885,Asterix & Obelix: Mission Cleopatra,108012365,0,108012365,2002.csv,2002,0.0,1.0
886,Neighbors 2: Sorority Rising,108007109,55455765,52551344,2016.csv,2016,0.5134455084803723,0.48655449151962765
887,Horrible Bosses 2,107645357,54445357,53200000,2014.csv,2014,0.5057845365313806,0.49421546346861944
888,Paul Blart: Mall Cop 2,107588225,71038190,36550035,2015.csv,2015,0.6602784830774929,0.33972151692250707
889,The Amityville Horror,107516369,65233369,42283000,2005.csv,2005,0.6067296506265013,0.39327034937349864
890,Clifford the Big Red Dog,107347356,48947356,58400000,2021.csv,2021,0.4559716962195138,0.5440283037804862
891,Vacation,107228221,58884188,48344033,2015.csv,2015,0.5491482321617552,0.45085176783824477
892,Shaft,107196498,70334258,36862240,2000.csv,2000,0.656124587204332,0.343875412795668
893,The Texas Chainsaw Massacre,107071655,80571655,26500000,2003.csv,2003,0.7525021911728179,0.24749780882718214
894,The Man from U.N.C.L.E.,107045109,45445109,61600000,2015.csv,2015,0.42454166682197503,0.575458333178025
895,The Breakup Guru,106980263,208959,106771304,2014.csv,2014,0.00195324814260365,0.9980467518573963
896,Chronicles of the Ghostly Tribe,106380000,0,106380000,2015.csv,2015,0.0,1.0
897,The Whole Nine Yards,106371651,57262492,49109159,2000.csv,2000,0.5383247459419428,0.46167525405805726
898,Shaun the Sheep Movie,106209378,19375982,86833396,2015.csv,2015,0.18243193176406702,0.817568068235933
899,About Schmidt,105834556,65016287,40818269,2002.csv,2002,0.6143200241705554,0.3856799758294446
900,First Man,105697415,44936545,60760870,2018.csv,2018,0.4251432733714443,0.5748567266285557
901,The Brothers Grimm,105316267,37916267,67400000,2005.csv,2005,0.36002289181024616,0.6399771081897538
902,Gangster Squad,105200903,46000903,59200000,2013.csv,2013,0.4372671877160598,0.5627328122839402
903,Along Came a Spider,105178561,74078174,31100387,2001.csv,2001,0.7043086851131192,0.2956913148868808
904,Sisters,105011053,87044645,17966408,2015.csv,2015,0.8289093625220576,0.17109063747794245
905,Training Day,104876233,76631907,28244326,2001.csv,2001,0.7306889731632523,0.2693110268367477
906,Scary Stories to Tell in the Dark,104545505,68947075,35598430,2019.csv,2019,0.6594934425922951,0.3405065574077049
907,The Hitchhiker's Guide to the Galaxy,104478416,51085416,53393000,2005.csv,2005,0.48895664727535687,0.5110433527246432
908,Book Club,104438188,68566296,35871892,2018.csv,2018,0.6565251400187065,0.34347485998129346
909,The Tuxedo,104391623,50547998,53843625,2002.csv,2002,0.4842150792118636,0.5157849207881364
910,Halloween Ends,104361355,64079860,40281495,2022.csv,2022,0.6140190494843614,0.3859809505156387
911,The Cell,104155843,61334059,42821784,2000.csv,2000,0.5888681540410555,0.4111318459589444
912,Wrath of Man,103966489,27466489,76500000,2021.csv,2021,0.26418598208120697,0.7358140179187931
913,Immortal Demon Slayer,103818506,0,103818506,2017.csv,2017,0.0,1.0
914,Detective Conan: Black Iron Submarine,103720914,0,103720914,2023.csv,2023,0.0,1.0
915,Ouija,103590271,50856010,52734261,2014.csv,2014,0.49093423068658637,0.5090657693134136
916,The Stepford Wives,103370127,59484742,43885385,2004.csv,2004,0.5754538929801257,0.42454610701987433
917,Rugrats in Paris,103291131,76507756,26783375,2000.csv,2000,0.7407001478181123,0.2592998521818877
918,Birdman or (The Unexpected Virtue of Ignorance),103215094,42340598,60874496,2014.csv,2014,0.41021711417518064,0.5897828858248194
919,Cold War 2,103197501,560824,102636677,2016.csv,2016,0.00543447268165922,0.9945655273183408
920,Guess Who,103121466,68915888,34205578,2005.csv,2005,0.6682981795468268,0.33170182045317315
921,Night School,103105878,77339130,25766748,2018.csv,2018,0.75009428657404,0.24990571342596005
922,Saw,103096345,55185045,47911300,2004.csv,2004,0.5352764445723076,0.4647235554276924
923,Transcendence,103039258,23022309,80016949,2014.csv,2014,0.22343240282262125,0.7765675971773788
924,Jimmy Neutron: Boy Genius,102992536,80936232,22056304,2001.csv,2001,0.7858456072972123,0.21415439270278772
925,Resident Evil,102984862,40119709,62865153,2002.csv,2002,0.3895689931594024,0.6104310068405976
926,Jigsaw,102952888,38052832,64900056,2017.csv,2017,0.3696140316141496,0.6303859683858505
927,Just Like Heaven,102854431,48318130,54536301,2005.csv,2005,0.4697719828910434,0.5302280171089566
928,Chappie,102811889,31569268,71242621,2015.csv,2015,0.3070585348354022,0.6929414651645979
929,Dawn of the Dead,102278712,59020957,43257755,2004.csv,2004,0.5770600337634287,0.4229399662365713
930,John Q,102244770,71756802,30487968,2002.csv,2002,0.7018139118509436,0.29818608814905645
931,Railroad Tigers,102205175,218044,101987131,2016.csv,2016,0.002133394908819441,0.9978666050911805
932,Heaven Is for Real,101888019,91443253,10444766,2014.csv,2014,0.8974877900020806,0.10251220999791938
933,Detective Conan: Zero the Enforcer,101860359,0,101860359,2018.csv,2018,0.0,1.0
934,Just Married,101564935,56127162,45437773,2003.csv,2003,0.5526234226408947,0.4473765773591053
935,Miss Congeniality 2: Armed & Fabulous,101393569,48478006,52915563,2005.csv,2005,0.4781171673718281,0.5218828326281719
936,The Recruit,101191884,52802140,48389744,2003.csv,2003,0.5218021239727091,0.47819787602729086
937,The Roundup,101166707,812859,100353848,2022.csv,2022,0.008034846879023155,0.9919651531209769
938,Joy,101134059,56451232,44682827,2015.csv,2015,0.5581822044737669,0.4418177955262332
939,Kung Fu Hustle,100912445,17108591,83803854,2004.csv,2004,0.16953896023429024,0.8304610397657097
940,"Alexander and the Terrible, Horrible, No Good, Very Bad Day",100654149,66954149,33700000,2014.csv,2014,0.665190155251325,0.334809844748675
941,Ladder 49,100572044,74541707,26030337,2004.csv,2004,0.7411772102394578,0.2588227897605422
942,Life,100541806,30234022,70307784,2017.csv,2017,0.30071095003008,0.69928904996992
943,Instructions Not Included,100486616,44467206,56019410,2013.csv,2013,0.44251869323572407,0.557481306764276
944,Tammy,100375432,84525432,15850000,2014.csv,2014,0.8420928340313395,0.15790716596866053
945,PK,100370104,10616104,89754000,2014.csv,2014,0.10576958254422054,0.8942304174557795
946,Philomena,100129872,37709979,62419893,2013.csv,2013,0.376610678180034,0.623389321819966
947,The Continent,100125957,0,100125957,2014.csv,2014,0.0,1.0
948,Don't Say a Word,100020092,55001642,45018450,2001.csv,2001,0.5499059328999617,0.45009406710003824
949,Atomic Blonde,100014025,51687870,48326155,2017.csv,2017,0.5168062179279356,0.48319378207206437
950,The Book of Life,99783556,50151543,49632013,2014.csv,2014,0.5026032846534353,0.4973967153465647
951,Black Mass,99775678,62575678,37200000,2015.csv,2015,0.6271636460340565,0.3728363539659435
952,Alpha,99630675,35857181,63773494,2018.csv,2018,0.35990101442151223,0.6400989855784878
953,Line Walker 2: Invisible Spy,99482027,296751,99185276,2019.csv,2019,0.002982960932229497,0.9970170390677705
954,Hellboy,99318987,59623958,39695029,2004.csv,2004,0.600327890980201,0.399672109019799
955,Shanghai Noon,99274467,56937502,42336965,2000.csv,2000,0.5735362145031713,0.42646378549682873
956,Blue Jasmine,99104804,33405481,65699323,2013.csv,2013,0.3370722674553698,0.6629277325446302
957,Ode to My Father,99085291,2300121,96785170,2014.csv,2014,0.023213546398122804,0.9767864536018772
958,Young Detective Dee: Rise of the Sea Dragon,98774891,87783,98687108,2013.csv,2013,0.0008887177612780155,0.999111282238722
959,Spotlight,98690254,45055776,53634478,2015.csv,2015,0.45653723821604514,0.5434627617839549
960,Devil and Angel,98599942,131058,98468884,2015.csv,2015,0.0013291894228497619,0.9986708105771502
961,The Visit,98450062,65206105,33243957,2015.csv,2015,0.6623267032579421,0.3376732967420579
962,Crash,98410061,54580300,43829761,2005.csv,2005,0.5546211377716757,0.4453788622283244
963,Evolution,98376292,38345494,60030798,2001.csv,2001,0.38978389224102894,0.6102161077589711
964,Riddick,98337295,42025135,56312160,2013.csv,2013,0.4273570368190421,0.572642963180958
965,Once Upon a Time in Mexico,98096026,56359780,41736246,2003.csv,2003,0.5745368318997958,0.4254631681002042
966,Along With the Gods: The Last 49 Days,97962238,1200246,96761992,2018.csv,2018,0.012252129233715547,0.9877478707662845
967,Are We There Yet?,97918663,82674398,15244265,2005.csv,2005,0.8443170634386623,0.15568293656133764
968,Phone Booth,97837138,46566212,51270926,2003.csv,2003,0.4759564001146477,0.5240435998853523
969,I Am Sam,97818139,40311852,57506287,2001.csv,2001,0.4121101915463757,0.5878898084536244
970,A Simple Favor,97644617,53548586,44096031,2018.csv,2018,0.5484028474401206,0.4515971525598795
971,Safe Haven,97594140,71349120,26245020,2013.csv,2013,0.7310799603336839,0.26892003966631606
972,The Little Prince,97571250,1339152,96232098,2015.csv,2015,0.013724862600407395,0.9862751373995926
973,Evil Dead,97542952,54239856,43303096,2013.csv,2013,0.5560612518677925,0.44393874813220746
974,42,97470701,95020213,2450488,2013.csv,2013,0.9748592348792074,0.025140765120792555
975,The Hustle,97409779,35417038,61992741,2019.csv,2019,0.3635881157270668,0.6364118842729332
976,The Woman King,97250903,67328130,29922773,2022.csv,2022,0.6923136744550331,0.30768632554496694
977,Jarhead,97076152,62658220,34417932,2005.csv,2005,0.6454543027210226,0.35454569727897745
978,Legend of the Demon Cat,97051623,0,97051623,2017.csv,2017,0.0,1.0
979,Enemy at the Gates,96976270,51401758,45574512,2001.csv,2001,0.530044700626246,0.469955299373754
980,The Shack,96942115,57386418,39555697,2017.csv,2017,0.5919658138261168,0.40803418617388326
981,Boonie Bears: The Big Shrink,96845907,0,96845907,2018.csv,2018,0.0,1.0
982,The Butterfly Effect,96693417,57938693,38754724,2004.csv,2004,0.5991999744925759,0.40080002550742416
983,Christmas with the Kranks,96572480,73780539,22791941,2004.csv,2004,0.7639913461888935,0.23600865381110644
984,13 Going on 30,96455697,57231747,39223950,2004.csv,2004,0.5933475033620875,0.4066524966379124
985,Red Eye,96258201,57891803,38366398,2005.csv,2005,0.6014220336405415,0.3985779663594586
986,The Tigger Movie,96159800,45554533,50605267,2000.csv,2000,0.4737378093548448,0.5262621906451552
987,Assassination,96119773,1904682,94215091,2015.csv,2015,0.019815714712518098,0.9801842852874819
988,The Manchurian Candidate,96105910,65955630,30150280,2004.csv,2004,0.6862806876288877,0.3137193123711122
989,The 6th Day,96085477,34604280,61481197,2000.csv,2000,0.36014058607420973,0.6398594139257903
990,The Favourite,95918706,34366783,61551923,2018.csv,2018,0.35829072798375744,0.6417092720162426
991,Be Cool,95763716,56046979,39716737,2005.csv,2005,0.5852632013569733,0.41473679864302676
992,Some Like It Hot,95721752,100026,95621726,2016.csv,2016,0.0010449662475881135,0.9989550337524119
993,Underworld,95708457,51970690,43737767,2003.csv,2003,0.5430104259229673,0.4569895740770327
994,The New King of Comedy,95618308,0,95618308,2019.csv,2019,0.0,1.0
995,Detective Conan: The Scarlet Bullet,95580715,0,95580715,2021.csv,2021,0.0,1.0
996,Poltergeist,95437994,47425125,48012869,2015.csv,2015,0.49692080703205055,0.5030791929679495
997,The Mortal Instruments: City of Bones,95396573,31165421,64231152,2013.csv,2013,0.32669329746258285,0.6733067025374172
998,Truth or Dare,95330493,41411015,53919478,2018.csv,2018,0.43439421843753606,0.565605781562464
999,Rush,95224595,26947624,68276971,2013.csv,2013,0.28299016656358583,0.7170098334364142
1000,40 Days and 40 Nights,95146283,37950822,57195461,2002.csv,2002,0.3988681512655623,0.6011318487344377
1001,Adoring,94975692,0,94975692,2019.csv,2019,0.0,1.0
1002,Changing Lanes,94935764,66818548,28117216,2002.csv,2002,0.7038290438153528,0.2961709561846471
1003,Kill Mobile,94870905,0,94870905,2018.csv,2018,0.0,1.0
1004,The Wedding Planner,94728529,60400856,34327673,2001.csv,2001,0.6376205419594344,0.3623794580405656
1005,I Feel Pretty,94539426,48795601,45743825,2018.csv,2018,0.5161402291568811,0.48385977084311893
1006,Veteran,94393020,1200627,93192393,2015.csv,2015,0.01271944684045494,0.9872805531595451
1007,Police Story: Lockdown,94249025,0,94249025,2013.csv,2013,0.0,1.0
1008,Fleet of Time,94244191,569280,93674911,2014.csv,2014,0.006040478399353017,0.9939595216006469
1009,Dirty Grandpa,94073028,35593113,58479915,2016.csv,2016,0.378356195784407,0.6216438042155931
1010,Ben-Hur,94061311,26410477,67650834,2016.csv,2016,0.2807793844166174,0.7192206155833827
1011,Blockers,94017294,60311495,33705799,2018.csv,2018,0.6414936277574634,0.35850637224253656
1012,The Skeleton Key,93983911,47907715,46076196,2005.csv,2005,0.5097437900833899,0.49025620991661006
1013,Syriana,93974620,50824620,43150000,2005.csv,2005,0.540833471845909,0.459166528154091
1014,In the Heart of the Sea,93920758,25020758,68900000,2015.csv,2015,0.26640285420183685,0.7335971457981632
1015,The Man from Macau,93864936,0,93864936,2014.csv,2014,0.0,1.0
1016,Evangelion: 3.0+1.01 Thrice Upon a Time,93763012,810744,92952268,2021.csv,2021,0.008646735879175894,0.9913532641208241
1017,Kill Zone 2,93638358,11998,93626360,2015.csv,2015,0.00012813125151126635,0.9998718687484888
1018,The Internship,93492844,44672764,48820080,2013.csv,2013,0.4778201420421011,0.5221798579578989
1019,BlacKkKlansman,93400823,49275340,44125483,2018.csv,2018,0.5275685847008008,0.47243141529919924
1020,Calendar Girls,93400759,31041759,62359000,2003.csv,2003,0.3323501792956522,0.6676498207043479
1021,Goosebumps 2: Slappy's Revenge,93320380,46700633,46619747,2018.csv,2018,0.5004333780038187,0.49956662199618135
1022,Money Monster,93282604,41012075,52270529,2016.csv,2016,0.43965405382551287,0.5603459461744872
1023,Secret Window,92913171,48022900,44890271,2004.csv,2004,0.5168578306298469,0.48314216937015314
1024,The Family Stone,92884429,60062868,32821561,2005.csv,2005,0.646640870236711,0.353359129763289
1025,House of Flying Daggers,92863945,11050094,81813851,2004.csv,2004,0.11899229566437222,0.8810077043356278
1026,Train to Busan,92742323,2129768,90612555,2016.csv,2016,0.022964359001445327,0.9770356409985547
1027,Downton Abbey: A New Era,92651580,44141550,48510030,2022.csv,2022,0.47642522663941617,0.5235747733605838
1028,Five Feet Apart,92554209,45729221,46824988,2019.csv,2019,0.49408040427421296,0.505919595725787
1029,Four Brothers,92374674,74494381,17880293,2005.csv,2005,0.806437281716415,0.19356271828358496
1030,Downfall,92181574,5509040,86672534,2004.csv,2004,0.059762919648128375,0.9402370803518716
1031,Southpaw,91970827,52421953,39548874,2015.csv,2015,0.5699845778270538,0.4300154221729462
1032,End Game,91824961,23149,91801812,2021.csv,2021,0.00025209920862367697,0.9997479007913763
1033,Behind Enemy Lines,91753202,58856790,32896412,2001.csv,2001,0.6414685124558378,0.3585314875441622
1034,Shadow,91708374,521396,91186978,2018.csv,2018,0.005685369582498541,0.9943146304175015
1035,Crawl,91542097,39014193,52527904,2019.csv,2019,0.4261885436161682,0.5738114563838318
1036,Rambo: Last Blood,91490353,44819352,46671001,2019.csv,2019,0.4898806325514997,0.5101193674485003
1037,Overboard,91244913,50316123,40928790,2018.csv,2018,0.551440308787406,0.448559691212594
1038,White Noise,91196419,56386759,34809660,2005.csv,2005,0.6183001440001717,0.38169985599982825
1039,Romeo Must Die,91036760,55973336,35063424,2000.csv,2000,0.6148432347548397,0.3851567652451603
1040,Final Destination 2,90941129,46961214,43979915,2003.csv,2003,0.5163913678705264,0.4836086321294736
1041,Paranormal Activity: The Marked Ones,90894962,32462372,58432590,2014.csv,2014,0.35714159823291414,0.6428584017670859
1042,Fantasia 2000,90874570,60655420,30219150,2000.csv,2000,0.667463075753756,0.33253692424624404
1043,Racing Stripes,90754475,49772522,40981953,2005.csv,2005,0.5484304988817356,0.45156950111826444
1044,Autumn in New York,90726668,37761915,52964753,2000.csv,2000,0.4162162662030088,0.5837837337969912
1045,Anchorman: The Legend of Ron Burgundy,90649730,85288303,5361427,2004.csv,2004,0.9408555657032845,0.0591444342967155
1046,My Big Fat Greek Wedding 2,90632641,59689605,30943036,2016.csv,2016,0.6585883887020351,0.34141161129796493
1047,Sherlock Gnomes,90497778,43242871,47254907,2018.csv,2018,0.4778335110062039,0.522166488993796
1048,Bring It On,90449929,68379000,22070929,2000.csv,2000,0.7559873264245459,0.24401267357545411
1049,Bedazzled,90383208,37886980,52496228,2000.csv,2000,0.4191816249761792,0.5808183750238208
1050,Jojo Rabbit,90335025,33370906,56964119,2019.csv,2019,0.369412705647671,0.630587294352329
1051,Identity,90259536,52159536,38100000,2003.csv,2003,0.5778839368285695,0.42211606317143047
1052,Old,90146510,48276510,41870000,2021.csv,2021,0.5355338770186444,0.4644661229813556
1053,Detective Dee: The Four Heavenly Kings,90040771,262963,89777808,2018.csv,2018,0.0029204880975530517,0.9970795119024469
1054,Air,89960106,52460106,37500000,2023.csv,2023,0.5831485569836923,0.4168514430163077
1055,The Hundred-Foot Journey,89514453,54240821,35273632,2014.csv,2014,0.6059448411085079,0.39405515889149206
1056,The Purge,89328627,64473115,24855512,2013.csv,2013,0.7217519978226017,0.2782480021773983
1057,K.G.F: Chapter 2,89123940,2874000,86249940,2022.csv,2022,0.032247227849217616,0.9677527721507824
1058,Transporter 2,89083229,43095856,45987373,2005.csv,2005,0.4837706994208753,0.5162293005791248
1059,Rumor Has It...,88933562,43000262,45933300,2005.csv,2005,0.4835099486963088,0.5164900513036912
1060,Kangaroo Jack,88929111,66934963,21994148,2003.csv,2003,0.7526777480098727,0.24732225199012728
1061,Collateral Beauty,88528280,31016021,57512259,2016.csv,2016,0.350351559976089,0.649648440023911
1062,Shanghai Knights,88323487,60476872,27846615,2003.csv,2003,0.6847201582971922,0.31527984170280776
1063,Line Walker,88228755,0,88228755,2016.csv,2016,0.0,1.0
1064,Dhoom 3,88031955,8031955,80000000,2013.csv,2013,0.09123908471645324,0.9087609152835467
1065,Chasing the Dragon,87965942,456854,87509088,2017.csv,2017,0.005193532742478902,0.9948064672575211
1066,Deliver Us from Evil,87937815,30577122,57360693,2014.csv,2014,0.3477130060600209,0.652286993939979
1067,Serial (Bad) Weddings 2,87761988,0,87761988,2019.csv,2019,0.0,1.0
1068,Gosford Park,87754044,41308615,46445429,2001.csv,2001,0.47073175339930773,0.5292682466006923
1069,Ali,87713825,58203105,29510720,2001.csv,2001,0.6635567996265127,0.3364432003734873
1070,Cocaine Bear,87649532,64388510,23261022,2023.csv,2023,0.7346132777982203,0.2653867222017797
1071,Don't Worry Darling,87609403,45309403,42300000,2022.csv,2022,0.5171751141826637,0.4828248858173363
1072,Tiger Lives,87320000,5560921,81759079,2017.csv,2017,0.06368439074667888,0.9363156092533211
1073,Pain & Gain,87305549,49875291,37430258,2013.csv,2013,0.5712728637672274,0.42872713623277253
1074,Sultan,87280000,6200000,81080000,2016.csv,2016,0.07103574702108158,0.9289642529789184
1075,A Million Ways to Die in the West,87189756,43139300,44050456,2014.csv,2014,0.49477486781818725,0.5052251321818128
1076,Old School,87135520,75585093,11550427,2003.csv,2003,0.8674429555249111,0.13255704447508893
1077,About Time,87100449,15322921,71777528,2013.csv,2013,0.17592241114623874,0.8240775888537613
1078,American Dreams in China,87097067,0,87097067,2013.csv,2013,0.0,1.0
1079,"Hello, Mrs. Money",86874070,0,86874070,2018.csv,2018,0.0,1.0
1080,Snowpiercer,86758912,4563650,82195262,2013.csv,2013,0.052601512568530136,0.9473984874314698
1081,Dragon Ball Super: Super Hero,86562140,38112140,48450000,2022.csv,2022,0.44028648090262096,0.5597135190973791
1082,Robin Hood,86489031,30824628,55664403,2018.csv,2018,0.35639927564918605,0.643600724350814
1083,Tears of the Sun,86468162,43734876,42733286,2003.csv,2003,0.5057916693082941,0.49420833069170594
1084,Sky High,86369815,63946815,22423000,2005.csv,2005,0.7403838366447815,0.2596161633552185
1085,A Taxi Driver,86252940,1527829,84725111,2017.csv,2017,0.01771335562590678,0.9822866443740932
1086,War Dogs,86234523,43034523,43200000,2016.csv,2016,0.4990405408747956,0.5009594591252045
1087,Step Up All In,86165646,14904384,71261262,2014.csv,2014,0.1729736233858213,0.8270263766141787
1088,I Can Only Imagine,86086881,83482352,2604529,2018.csv,2018,0.9697453436604353,0.030254656339564676
1089,John Wick,86013056,43037835,42975221,2014.csv,2014,0.5003639796265348,0.49963602037346516
1090,The Second Best Exotic Marigold Hotel,85978266,33078266,52900000,2015.csv,2015,0.38472822887588826,0.6152717711241118
1091,Match Point,85638656,23151529,62487127,2005.csv,2005,0.2703397050042448,0.7296602949957552
1092,The Roundup: No Way Out,85615674,909411,84706263,2023.csv,2023,0.010622015309953643,0.9893779846900463
1093,Paper Towns,85512300,32000304,53511996,2015.csv,2015,0.37421872642882953,0.6257812735711704
1094,Rat Race,85498534,56618055,28880479,2001.csv,2001,0.6622108280827365,0.33778917191726354
1095,Big Fish & Begonia,85409373,0,85409373,2016.csv,2016,0.0,1.0
1096,Nerve,85251425,38583626,46667799,2016.csv,2016,0.4525862881470896,0.5474137118529103
1097,Hidden Man,85170581,0,85170581,2018.csv,2018,0.0,1.0
1098,Final Fantasy: The Spirits Within,85131830,32131830,53000000,2001.csv,2001,0.3774361481481133,0.6225638518518867
1099,No Hard Feelings,84981563,50285988,34695575,2023.csv,2023,0.5917282081526318,0.4082717918473681
1100,Going in Style,84918541,45018541,39900000,2017.csv,2017,0.5301379471416025,0.46986205285839755
1101,Sicario,84872444,46889293,37983151,2015.csv,2015,0.5524678068655593,0.44753219313444065
1102,Carrie,84790678,35266619,49524059,2013.csv,2013,0.41592566343201076,0.5840743365679892
1103,Dog,84774243,61778069,22996174,2022.csv,2022,0.7287363096831192,0.2712636903168808
1104,The Animal,84772742,57743062,27029680,2001.csv,2001,0.6811512832745223,0.31884871672547765
1105,Mamma Mia! 2020 Re-release,84579977,0,84579977,2020.csv,2020,0.0,1.0
1106,Mortal Kombat,84426031,42326031,42100000,2021.csv,2021,0.5013386333416526,0.49866136665834737
1107,The Judge,84419388,47119388,37300000,2014.csv,2014,0.5581583699706517,0.44184163002934823
1108,Leap!,84197417,2844490,81352927,2016.csv,2016,0.0337835779451524,0.9662164220548476
1109,Finding Mr. Right,84112033,6945,84105088,2013.csv,2013,8.256844772733052e-05,0.9999174315522726
1110,Our Times,83867493,0,83867493,2015.csv,2015,0.0,1.0
1111,In Her Shoes,83697473,32880591,50816882,2005.csv,2005,0.3928504627612831,0.6071495372387169
1112,Mortal Engines,83672673,15951040,67721633,2018.csv,2018,0.19063619492591088,0.8093638050740891
1113,Snatch,83557872,30328156,53229716,2000.csv,2000,0.3629598896439105,0.6370401103560895
1114,Blow,83282296,52990775,30291521,2001.csv,2001,0.6362789877935162,0.36372101220648384
1115,Rings,83080890,27793018,55287872,2017.csv,2017,0.33452961324800445,0.6654703867519955
1116,Suck Me Shakespeer 2,83027924,0,83027924,2015.csv,2015,0.0,1.0
1117,Once Upon A Time,82886178,485728,82400450,2017.csv,2017,0.005860180933906736,0.9941398190660933
1118,The Fighter Pilot,82879386,0,82879386,2013.csv,2013,0.0,1.0
1119,28 Days Later,82719885,45064915,37654970,2002.csv,2002,0.5447893816583521,0.45521061834164783
1120,The Constant Gardener,82466670,33579797,48886873,2005.csv,2005,0.4071923481328881,0.5928076518671119
1121,Hitman: Agent 47,82347656,22467450,59880206,2015.csv,2015,0.2728365455842483,0.7271634544157517
1122,Men of Honor,82343495,48818921,33524574,2000.csv,2000,0.5928691877846575,0.4071308122153426
1123,Tiny Times 3.0,82320000,0,82320000,2014.csv,2014,0.0,1.0
1124,Reign of Fire,82150183,43061982,39088201,2002.csv,2002,0.5241860751545739,0.4758139248454261
1125,Catwoman,82102379,40202379,41900000,2004.csv,2004,0.48966156023323026,0.5103384397667697
1126,Miracle in Cell No. 7,82101723,0,82101723,2013.csv,2013,0.0,1.0
1127,The Chorus,82032134,2087128,79945006,2004.csv,2004,0.025442810009063035,0.974557189990937
1128,Ouija: Origin of Evil,81705746,35144505,46561241,2016.csv,2016,0.43013504827432825,0.5698649517256718
1129,One Piece: Stampede,81562741,1298528,80264213,2019.csv,2019,0.01592060276640286,0.9840793972335972
1130,Wolf Warrior,81411331,0,81411331,2015.csv,2015,0.0,1.0
1131,Gone with the Bullets,81387479,0,81387479,2014.csv,2014,0.0,1.0
1132,iPartment the Movie,81096321,0,81096321,2018.csv,2018,0.0,1.0
1133,Underworld: Blood Wars,81093313,30353973,50739340,2016.csv,2016,0.37430919858953104,0.625690801410469
1134,Doraemon the Movie: Nobita's Treasure Island,80920916,0,80920916,2018.csv,2018,0.0,1.0
1135,Sinbad: Legend of the Seven Seas,80773077,26483452,54289625,2003.csv,2003,0.32787474469989547,0.6721252553001045
1136,A Dog's Way Home,80708134,42004346,38703788,2019.csv,2019,0.5204474929379485,0.4795525070620515
1137,The Rookie,80693537,75600072,5093465,2002.csv,2002,0.9368788977486512,0.06312110225134883
1138,The Rundown,80657921,47726342,32931579,2003.csv,2003,0.5917130197293332,0.4082869802706668
1139,Go Away Mr. Tumor,80606893,286639,80320254,2015.csv,2015,0.0035560110225312867,0.9964439889774687
1140,Jackass Forever,80563999,57743451,22820548,2022.csv,2022,0.7167401285529533,0.28325987144704673
1141,Caught in Time,80543319,0,80543319,2020.csv,2020,0.0,1.0
1142,Den of Thieves,80509622,44947622,35562000,2018.csv,2018,0.5582888216764947,0.44171117832350526
1143,Muppets Most Wanted,80383113,51183113,29200000,2014.csv,2014,0.6367396221641727,0.36326037783582726
1144,Hereditary,80200936,44069456,36131480,2018.csv,2018,0.5494880508626483,0.4505119491373517
1145,Runaway Jury,80154140,49443628,30710512,2003.csv,2003,0.6168568211199073,0.3831431788800928
1146,Finding Forrester,80049764,51804714,28245050,2000.csv,2000,0.6471563613854002,0.3528436386145998
1147,Exit Wounds,79958599,51758599,28200000,2001.csv,2001,0.6473174823886046,0.35268251761139535
1148,The Wedding Ringer,79799880,64460211,15339669,2015.csv,2015,0.8077732823658381,0.19222671763416185
1149,The Menu,79628200,38501125,41127075,2022.csv,2022,0.4835111807123607,0.5164888192876393
1150,Jackass: The Movie,79493831,64255312,15238519,2002.csv,2002,0.8083056407232405,0.19169435927675949
1151,Good Bye Lenin!,79316957,4064200,75252757,2003.csv,2003,0.05123998894713018,0.9487600110528698
1152,Stealth,79268322,32116746,47151576,2005.csv,2005,0.40516495353591564,0.5948350464640844
1153,Paradox,79226860,0,79226860,2017.csv,2017,0.0,1.0
1154,Manchester by the Sea,78988148,47695371,31292777,2016.csv,2016,0.603829463124012,0.396170536875988
1155,Lady Bird,78965611,48958273,30007338,2017.csv,2017,0.6199948608008617,0.3800051391991382
1156,Paranormal Activity: The Ghost Dimension,78903124,18300124,60603000,2015.csv,2015,0.2319315519116835,0.7680684480883165
1157,A Dog's Journey,78870908,22782371,56088537,2019.csv,2019,0.2888564564262402,0.7111435435737598
1158,The Boss,78844582,63285885,15558697,2016.csv,2016,0.8026662504216207,0.1973337495783794
1159,Code Blue: The Movie,78778562,0,78778562,2018.csv,2018,0.0,1.0
1160,Spanish Affair,78768613,0,78768613,2014.csv,2014,0.0,1.0
1161,The Attorney,78547586,557236,77990350,2013.csv,2013,0.007094247301247424,0.9929057526987526
1162,The Family,78418811,36918811,41500000,2013.csv,2013,0.47079024189744473,0.5292097581025552
1163,Collateral Damage,78382433,40077257,38305176,2002.csv,2002,0.5113040698800457,0.4886959301199543
1164,Scary Movie V,78378744,32015787,46362957,2013.csv,2013,0.4084753769465864,0.5915246230534136
1165,R.I.P.D.,78324220,33618855,44705365,2013.csv,2013,0.4292268087700075,0.5707731912299925
1166,If I Stay,78274843,50474843,27800000,2014.csv,2014,0.6448411911857811,0.3551588088142189
1167,Boonie Bears: The Wild Life,78132231,0,78132231,2021.csv,2021,0.0,1.0
1168,Tag,78130625,54730625,23400000,2018.csv,2018,0.7005015638874001,0.2994984361125999
1169,Head Full of Honey,78127384,0,78127384,2014.csv,2014,0.0,1.0
1170,Exorcist: The Beginning,78110021,41821986,36288035,2004.csv,2004,0.5354240783010416,0.46457592169895845
1171,The Left Ear,78015473,0,78015473,2015.csv,2015,0.0,1.0
1172,Shin Godzilla,77947607,1918403,76029204,2016.csv,2016,0.024611441888139043,0.975388558111861
1173,Tiny Times 4.0,77750000,0,77750000,2015.csv,2015,0.0,1.0
1174,Showtime,77741732,38082712,39659020,2002.csv,2002,0.4898618929663157,0.5101381070336843
1175,Tiny Times,77717014,23462,77693552,2013.csv,2013,0.0003018901369525082,0.9996981098630475
1176,Suck Me Shakespeer,77676735,0,77676735,2013.csv,2013,0.0,1.0
1177,Windtalkers,77628265,40914068,36714197,2002.csv,2002,0.5270511713742411,0.47294882862575893
1178,Hostage,77608617,34639939,42968678,2005.csv,2005,0.4463414030429121,0.5536585969570879
1179,Serendipity,77516304,50294317,27221987,2001.csv,2001,0.6488224335360468,0.3511775664639532
1180,Candyman,77411570,61186570,16225000,2021.csv,2021,0.7904060077841077,0.20959399221589228
1181,Fantastica: A Boonie Bears Adventure,77151096,0,77151096,2017.csv,2017,0.0,1.0
1182,Mike and Dave Need Wedding Dates,77068246,46009673,31058573,2016.csv,2016,0.596999093504736,0.40300090649526393
1183,Barbershop,77063924,75782105,1281819,2002.csv,2002,0.983366808573101,0.01663319142689905
1184,The Forever Purge,76994245,44539245,32455000,2021.csv,2021,0.5784749886176558,0.4215250113823442
1185,"I, Frankenstein",76801179,19075290,57725889,2014.csv,2014,0.248372358971208,0.751627641028792
1186,Chebi: My Fluffy Friend,76795223,0,76795223,2023.csv,2023,0.0,1.0
1187,Sanju,76693052,7909317,68783735,2018.csv,2018,0.10312951165380665,0.8968704883461933
1188,Coach Carter,76669554,67264877,9404677,2005.csv,2005,0.8773349196735903,0.12266508032640962
1189,The Ladykillers,76665191,39799191,36866000,2004.csv,2004,0.519129874730241,0.480870125269759
1190,The Book Thief,76586316,21488481,55097835,2013.csv,2013,0.28057859578987976,0.7194214042101202
1191,Bend It Like Beckham,76583333,32543449,44039884,2002.csv,2002,0.4249416645264055,0.5750583354735945
1192,Bad Santa,76488889,60060328,16428561,2003.csv,2003,0.7852163730604061,0.2147836269395938
1193,The Road to El Dorado,76432727,50863742,25568985,2000.csv,2000,0.665470721723693,0.33452927827630696
1194,Cold Pursuit,76419755,32138862,44280893,2019.csv,2019,0.42055698817668286,0.5794430118233171
1195,(T)Raumschiff Surprise - Periode 1,76341401,0,76341401,2004.csv,2004,0.0,1.0
1196,Tae Guk Gi: The Brotherhood of War,76287982,1111061,75176921,2004.csv,2004,0.01456403709826798,0.985435962901732
1197,Kubo and the Two Strings,76249438,48023088,28226350,2016.csv,2016,0.6298156322148892,0.37018436778511077
1198,The Pope's Exorcist,76160110,20009380,56150730,2023.csv,2023,0.2627278243164302,0.7372721756835697
1199,Vice,76073488,47836282,28237206,2018.csv,2018,0.6288167304751426,0.3711832695248573
1200,Kate & Leopold,76019048,47121859,28897189,2001.csv,2001,0.6198691017546023,0.38013089824539764
1201,West Side Story,76016171,38530322,37485849,2021.csv,2021,0.5068700711063177,0.49312992889368235
1202,Avatar 2022 Re-release,76012917,24714024,51298893,2022.csv,2022,0.32512926717441987,0.6748707328255802
1203,Violent Night,76004405,50057405,25947000,2022.csv,2022,0.6586118922975582,0.3413881077024417
1204,Widows,75984700,42402632,33582068,2018.csv,2018,0.5580417110286676,0.4419582889713324
1205,Quo vado?,75878701,0,75878701,2016.csv,2016,0.0,1.0
1206,Sicario: Day of the Soldado,75837743,50072235,25765508,2018.csv,2018,0.6602548153364743,0.33974518466352566
1207,Dreamcatcher,75715436,33715436,42000000,2003.csv,2003,0.44529144625146183,0.5547085537485381
1208,Cats,75558925,27166770,48392155,2019.csv,2019,0.35954415709328846,0.6404558429067115
1209,Bajrangi Bhaijaan,75547184,8178001,67369183,2015.csv,2015,0.10825024265629808,0.8917497573437019
1210,Manitou's Shoe,75482094,0,75482094,2001.csv,2001,0.0,1.0
1211,Searching,75462037,26020957,49441080,2018.csv,2018,0.3448218208050758,0.6551781791949242
1212,The Count of Monte Cristo,75395048,54234062,21160986,2002.csv,2002,0.719331885033086,0.280668114966914
1213,The Spy Who Dumped Me,75320680,33562069,41758611,2018.csv,2018,0.4455890334500432,0.5544109665499568
1214,1921,75159828,0,75159828,2021.csv,2021,0.0,1.0
1215,Animal World,74922830,0,74922830,2018.csv,2018,0.0,1.0
1216,Boo! A Madea Halloween,74827344,73206343,1621001,2016.csv,2016,0.9783367828744529,0.021663217125547047
1217,A Madea Family Funeral,74747725,73257045,1490680,2019.csv,2019,0.9800571856869222,0.019942814313077754
1218,Crimson Peak,74679822,31090320,43589502,2014.csv,2014,0.4163148648104705,0.5836851351895295
1219,Escape from Planet Earth,74597643,57012977,17584666,2013.csv,2013,0.7642731687916735,0.23572683120832652
1220,From Hell,74558115,31602566,42955549,2001.csv,2001,0.4238648737297074,0.5761351262702926
1221,The King and the Clown,74466867,0,74466867,2005.csv,2005,0.0,1.0
1222,August: Osage County,74188937,37738810,36450127,2013.csv,2013,0.5086851426379111,0.4913148573620889
1223,Eternal Sunshine of the Spotless Mind,74036715,34400301,39636414,2004.csv,2004,0.4646384027168142,0.5353615972831858
1224,Miracles from Heaven,73983003,61705123,12277880,2016.csv,2016,0.8340445845378837,0.16595541546211634
1225,Divine Secrets of the Ya-Ya Sisterhood,73839240,69599016,4240224,2002.csv,2002,0.94257492357722,0.05742507642278008
1226,Strange World,73621640,37968963,35652677,2022.csv,2022,0.5157310133270598,0.48426898667294016
1227,Crying Out Love in the Center of the World,73611055,0,73611055,2004.csv,2004,0.0,1.0
1228,The Core,73498611,31186896,42311715,2003.csv,2003,0.4243195289772211,0.575680471022779
1229,Charlie's Angels,73279888,17803077,55476811,2019.csv,2019,0.24294629107511737,0.7570537089248827
1230,War Room,73267874,67790117,5477757,2015.csv,2015,0.9252365777666758,0.07476342223332426
1231,"Dude, Where's My Car?",73180723,46729800,26450923,2000.csv,2000,0.6385534070222291,0.36144659297777093
1232,My Old Classmate,73052128,0,73052128,2014.csv,2014,0.0,1.0
1233,Without a Paddle,73029190,58169327,14859863,2004.csv,2004,0.7965215963644127,0.20347840363558736
1234,The Best Man Holiday,72835710,70525195,2310515,2013.csv,2013,0.9682777170703766,0.0317222829296234
1235,The Bélier Family,72751538,0,72751538,2014.csv,2014,0.0,1.0
1236,The One,72689126,43905746,28783380,2001.csv,2001,0.6040208269941229,0.3959791730058771
1237,"Yours, Mine & Ours",72662923,53412862,19250061,2005.csv,2005,0.7350772552874043,0.26492274471259575
1238,Detective Conan: The Bride of Halloween,72653401,0,72653401,2022.csv,2022,0.0,1.0
1239,The Transporter Refueled,72629670,16029670,56600000,2015.csv,2015,0.22070415575342694,0.779295844246573
1240,Lord of War,72617068,24149632,48467436,2005.csv,2005,0.3325613752403223,0.6674386247596777
1241,Amazing China,72506343,0,72506343,2018.csv,2018,0.0,1.0
1242,Doctor Sleep,72381712,31581712,40800000,2019.csv,2019,0.4363217051290525,0.5636782948709476
1243,Second Act,72282227,39282227,33000000,2018.csv,2018,0.5434562357908536,0.45654376420914644
1244,What Men Want,72216294,54611903,17604391,2019.csv,2019,0.7562268841987377,0.24377311580126224
1245,Around the World in 80 Days,72178895,24008137,48170758,2004.csv,2004,0.33261990225813237,0.6673800977418676
1246,The Adventures of Sharkboy and Lavagirl 3-D,71992655,39177684,32814971,2005.csv,2005,0.5441900149397185,0.4558099850602815
1247,"O Brother, Where Art Thou?",71868327,45512588,26355739,2000.csv,2000,0.6332774102282915,0.36672258977170846
1248,Rules of Engagement,71732303,61335230,10397073,2000.csv,2000,0.8550573093965769,0.14494269060342313
1249,Interstellar 2021 Re-release,71712456,0,71712456,2022.csv,2022,0.0,1.0
1250,Run All Night,71561644,26461644,45100000,2015.csv,2015,0.3697741208963841,0.6302258791036159
1251,The Royal Tenenbaums,71441250,52364010,19077240,2001.csv,2001,0.7329660385281612,0.2670339614718387
1252,Brick Mansions,71416730,20396829,51019901,2014.csv,2014,0.28560295325759105,0.714397046742409
1253,xXx: State of the Union,71410636,26873932,44536704,2005.csv,2005,0.37632954284288966,0.6236704571571103
1254,Holes,71406573,67406573,4000000,2003.csv,2003,0.9439827479187385,0.05601725208126148
1255,Down to Earth,71186502,64186502,7000000,2001.csv,2001,0.9016667513737365,0.09833324862626344
1256,The Counselor,71009334,16973715,54035619,2013.csv,2013,0.23903498376706364,0.7609650162329363
1257,Anacondas: The Hunt for the Blood Orchid,70992898,32238923,38753975,2004.csv,2004,0.45411476229636377,0.5458852377036362
1258,Son of God,70829270,59700064,11129206,2014.csv,2014,0.842872784090532,0.15712721590946793
1259,I Am Not Madame Bovary,70826207,436798,70389409,2016.csv,2016,0.006167180461887504,0.9938328195381125
1260,Taxi 2004 Re-release,70778329,36611066,34167263,2004.csv,2004,0.5172637799911891,0.4827362200088109
1261,Brotherhood of the Wolf,70752904,11260096,59492808,2001.csv,2001,0.15914676802523894,0.840853231974761
1262,Spirited Away 2018 Re-release,70186029,1175067,69010962,2018.csv,2018,0.016742178133485795,0.9832578218665142
1263,Think Like a Man Too,70181428,65182182,4999246,2014.csv,2014,0.9287668241803231,0.07123317581967696
1264,Titanic 25 Year Anniversary,70157472,15033795,55123677,2023.csv,2023,0.21428644122182738,0.7857135587781726
1265,A Cinderella Story,70067909,51438175,18629734,2004.csv,2004,0.7341188817265832,0.2658811182734167
1266,See You Tomorrow,70065569,0,70065569,2016.csv,2016,0.0,1.0
1267,Hitman's Wife's Bodyguard,70060492,38014727,32045765,2021.csv,2021,0.5425986303379086,0.45740136966209144
1268,Mulan,69965374,0,69965374,2020.csv,2020,0.0,1.0
1269,Sole a catinelle,69903094,0,69903094,2013.csv,2013,0.0,1.0
1270,The Northman,69633110,34233110,35400000,2022.csv,2022,0.49162115551064717,0.5083788444893529
1271,Exit,69501772,470699,69031073,2019.csv,2019,0.006772474808268198,0.9932275251917319
1272,After,69497587,12138565,57359022,2019.csv,2019,0.1746616756636457,0.8253383243363543
1273,A Very Long Engagement,69424389,6524389,62900000,2004.csv,2004,0.0939783423949183,0.9060216576050817
1274,Playing with Fire,69412425,44451847,24960578,2019.csv,2019,0.6404018732957392,0.3595981267042608
1275,13 Hours,69411370,52853219,16558151,2015.csv,2015,0.7614490104431018,0.23855098955689824
1276,E.T. the Extra-Terrestrial 20th Anniversary,69177751,35306015,33871736,2002.csv,2002,0.5103666206205518,0.4896333793794482
1277,Running Man,68782475,310978,68471497,2015.csv,2015,0.004521180722269735,0.9954788192777303
1278,House of Wax,68766121,32064800,36701321,2005.csv,2005,0.46628775236573256,0.5337122476342675
1279,The Nut Job 2: Nutty by Nature,68743485,28370522,40372963,2017.csv,2017,0.41270124725273966,0.5872987527472603
1280,The Sweetest Thing,68696770,24718164,43978606,2002.csv,2002,0.35981551971075204,0.6401844802892479
1281,The Call,68572631,51872378,16700253,2013.csv,2013,0.7564589143444124,0.24354108565558757
1282,One Direction: This Is Us,68532898,28873374,39659524,2013.csv,2013,0.4213067715303678,0.5786932284696322
1283,Looney Tunes: Back in Action,68514844,20991364,47523480,2003.csv,2003,0.3063768779799017,0.6936231220200983
1284,Thir13en Ghosts,68467960,41867960,26600000,2001.csv,2001,0.6114971148548898,0.3885028851451102
1285,Pokémon 3 the Movie: Spell of the Unown,68411275,17052128,51359147,2001.csv,2001,0.24925902930474544,0.7507409706952546
1286,Ghost Ship,68349884,30113491,38236393,2002.csv,2002,0.4405785238786945,0.5594214761213054
1287,Stalingrad,68316452,1013945,67302507,2013.csv,2013,0.014841886109659207,0.9851581138903408
1288,Open Range,68296293,58331254,9965039,2003.csv,2003,0.8540910705065646,0.1459089294934353
1289,Frequency,68106245,45010278,23095967,2000.csv,2000,0.6608832714239348,0.33911672857606523
1290,The Yin-Yang Master: Dream of Eternity,68000000,0,68000000,2020.csv,2020,0.0,1.0
1291,Shoplifters,67999335,3313513,64685822,2018.csv,2018,0.04872860889007223,0.9512713911099278
1292,Prime,67937494,22827153,45110341,2005.csv,2005,0.33600228174445174,0.6639977182555482
1293,A Beautiful Day in the Neighborhood,67925733,61704055,6221678,2019.csv,2019,0.9084046984078921,0.09159530159210796
1294,Jersey Boys,67647013,47047013,20600000,2014.csv,2014,0.6954780545890474,0.30452194541095257
1295,Bandits,67631903,41575141,26056762,2001.csv,2001,0.614726765857823,0.38527323414217696
1296,12 Strong,67450815,45819713,21631102,2018.csv,2018,0.6793055502739292,0.32069444972607075
1297,Star Trek: Nemesis,67336470,43254409,24082061,2002.csv,2002,0.6423622889646576,0.35763771103534236
1298,Moonfall,67295363,19060660,48234703,2022.csv,2022,0.28323883177508086,0.7167611682249192
1299,American Assassin,67234188,36249674,30984514,2017.csv,2017,0.5391553773208356,0.4608446226791644
1300,Boogeyman,67192859,46752382,20440477,2005.csv,2005,0.6957939086949702,0.3042060913050299
1301,War,67179155,4654000,62525155,2019.csv,2019,0.06927744178979328,0.9307225582102068
1302,The Giver,66980456,45090374,21890082,2014.csv,2014,0.6731870263767687,0.32681297362323125
1303,The Boogeyman,66978229,43244282,23733947,2023.csv,2023,0.6456468414535117,0.3543531585464883
1304,Selma,66787908,52076908,14711000,2014.csv,2014,0.779735577284439,0.22026442271556101
1305,A Violent Prosecutor,66736633,0,66736633,2015.csv,2015,0.0,1.0
1306,Thirteen Days,66579890,34592089,31987801,2000.csv,2000,0.5195576171723925,0.48044238282760754
1307,Victoria & Abdul,66558465,22245070,44313395,2017.csv,2017,0.33421849497280326,0.6657815050271968
1308,Not Another Teen Movie,66468332,38252284,28216048,2001.csv,2001,0.5754963732202577,0.4245036267797423
1309,"Love, Simon",66316289,40826341,25489948,2018.csv,2018,0.615630663531248,0.38436933646875204
1310,Mile 22,66308758,36108758,30200000,2018.csv,2018,0.5445548836851989,0.4554451163148011
1311,One Piece Film: Gold,66207073,423593,65783480,2016.csv,2016,0.00639800221949096,0.9936019977805091
1312,Barbershop 2: Back in Business,65991448,65111277,880171,2004.csv,2004,0.9866623475211516,0.013337652478848471
1313,Bad Company,65977295,30160161,35817134,2002.csv,2002,0.45712939580199524,0.5428706041980048
1314,Life of the Party,65859911,53059911,12800000,2018.csv,2018,0.8056480823364611,0.1943519176635389
1315,Beijing Love Story,65842375,428318,65414057,2014.csv,2014,0.0065052027664554936,0.9934947972335445
1316,Stuck on You,65784503,33832741,31951762,2003.csv,2003,0.5142965205650334,0.4857034794349666
1317,Escape Room: Tournament of Champions,65774490,25314753,40459737,2021.csv,2021,0.3848719009451841,0.6151280990548159
1318,Sweet November,65754228,25288103,40466125,2001.csv,2001,0.384585201121972,0.6154147988780281
1319,K-19: The Widowmaker,65716126,35168966,30547160,2002.csv,2002,0.5351649304464478,0.4648350695535522
1320,The Age of Adaline,65663276,42629776,23033500,2015.csv,2015,0.6492179281460158,0.35078207185398425
1321,Matchstick Men,65565672,36906460,28659212,2003.csv,2003,0.5628930334154129,0.43710696658458714
1322,Taxi 3,65497208,497208,65000000,2003.csv,2003,0.007591285417845597,0.9924087145821544
1323,Taking Lives,65470529,32682342,32788187,2004.csv,2004,0.4991916591967662,0.5008083408032338
1324,Doraemon: Nobita's Chronicle of the Moon Exploration,65406606,0,65406606,2019.csv,2019,0.0,1.0
1325,The House That Never Dies,65220000,0,65220000,2014.csv,2014,0.0,1.0
1326,Stand by Me Doraemon 2,65201374,0,65201374,2020.csv,2020,0.0,1.0
1327,Moonlight,65172611,27854932,37317679,2016.csv,2016,0.4274024252304392,0.5725975747695607
1328,Zathura: A Space Adventure,65079104,29258869,35820235,2005.csv,2005,0.44958930288898874,0.5504106971110112
1329,K-PAX,65001485,50338485,14663000,2001.csv,2001,0.7744205382384726,0.22557946176152746
1330,The Pirates,64858224,415775,64442449,2014.csv,2014,0.006410520892462304,0.9935894791075377
1331,God's Not Dead,64667874,60755732,3912142,2014.csv,2014,0.9395040882277961,0.060495911772203925
1332,Belle,64666502,4018313,60648189,2021.csv,2021,0.0621390190550279,0.9378609809449721
1333,Happy Death Day 2U,64600152,28148130,36452022,2019.csv,2019,0.43572854131984085,0.5642714586801592
1334,L Storm,64517456,0,64517456,2018.csv,2018,0.0,1.0
1335,Monster Trucks,64493915,33370166,31123749,2016.csv,2016,0.5174157282900255,0.4825842717099745
1336,Monk Comes Down the Mountain,64455686,0,64455686,2015.csv,2015,0.0,1.0
1337,Miracle,64445708,64378093,67615,2004.csv,2004,0.9989508222952567,0.0010491777047433478
1338,Kiss of the Dragon,64437847,36845124,27592723,2001.csv,2001,0.5717932195965517,0.4282067804034483
1339,Capernaum,64417003,1661096,62755907,2018.csv,2018,0.025786607923997954,0.974213392076002
1340,Fences,64414761,57682904,6731857,2016.csv,2016,0.8954920130806664,0.10450798691933359
1341,Zhongkui: Snow Girl and the Dark Crystal,64325947,165428,64160519,2015.csv,2015,0.002571714956641058,0.9974282850433589
1342,Isle of Dogs,64241499,32015231,32226268,2018.csv,2018,0.49835747139088393,0.5016425286091161
1343,The Rescue,64237554,18797,64218757,2020.csv,2020,0.0002926169947255464,0.9997073830052745
1344,Suck Me Shakespeer 3,64236772,0,64236772,2017.csv,2017,0.0,1.0
1345,Thunder and the House of Magic,64197205,4091,64193114,2013.csv,2013,6.372551577595941e-05,0.9999362744842241
1346,The Danish Girl,64191523,11114018,53077505,2015.csv,2015,0.1731384064528271,0.8268615935471729
1347,The Boy,64188367,35819556,28368811,2015.csv,2015,0.5580381255064488,0.4419618744935511
1348,The Grandmaster,64076736,6594959,57481777,2013.csv,2013,0.10292282990194757,0.8970771700980524
1349,The Pirate Fairy,63998725,0,63998725,2014.csv,2014,0.0,1.0
1350,The Inbetweeners 2,63852235,0,63852235,2014.csv,2014,0.0,1.0
1351,High Crimes,63781810,41543917,22237893,2002.csv,2002,0.651344278251119,0.34865572174888104
1352,"Hail, Caesar!",63647656,30498085,33149571,2016.csv,2016,0.4791705919225054,0.5208294080774947
1353,Begin Again,63464861,16170632,47294229,2014.csv,2014,0.25479661887229216,0.7452033811277078
1354,Side Effects,63414135,32172757,31241378,2013.csv,2013,0.5073436229950941,0.49265637700490594
1355,Babylon,63379032,15351455,48027577,2022.csv,2022,0.242216621421419,0.757783378578581
1356,The Host,63365859,26627201,36738658,2013.csv,2013,0.42021368320754554,0.5797863167924544
1357,The Hundred Regiments Offensive,63230000,0,63230000,2015.csv,2015,0.0,1.0
1358,Detective Conan: Crimson Love Letter,63144805,0,63144805,2017.csv,2017,0.0,1.0
1359,Jeepers Creepers 2,63102666,35667218,27435448,2003.csv,2003,0.5652252156826464,0.43477478431735356
1360,The Longest Ride,62944815,37446117,25498698,2015.csv,2015,0.5949039170263667,0.4050960829736333
1361,Unfriended,62882090,32482090,30400000,2015.csv,2015,0.5165555088897331,0.4834444911102668
1362,Piglet's Big Movie,62870546,23103423,39767123,2003.csv,2003,0.36747609922140645,0.6325239007785936
1363,The Mountain Between Us,62832209,30348555,32483654,2017.csv,2017,0.48300951825519933,0.5169904817448007
1364,The Star,62812974,40852824,21960150,2017.csv,2017,0.65038830990553,0.34961169009446996
1365,The Nice Guys,62788218,36261763,26526455,2016.csv,2016,0.5775249585837904,0.4224750414162097
1366,Proof of Life,62761005,32598931,30162074,2000.csv,2000,0.5194137824912141,0.4805862175087859
1367,Runner Runner,62675095,19316646,43358449,2013.csv,2013,0.3082028994132358,0.6917971005867641
1368,After the Sunset,62657868,28331233,34326635,2004.csv,2004,0.45215762847213375,0.5478423715278662
1369,How to Be a Latin Lover,62547032,32149404,30397628,2017.csv,2017,0.5140036700702281,0.4859963299297719
1370,The White Haired Witch of Lunar Kingdom,62515046,0,62515046,2014.csv,2014,0.0,1.0
1371,Andhadhun,62475342,1193046,61282296,2018.csv,2018,0.019096270013215774,0.9809037299867842
1372,Snow Day,62464731,60020107,2444624,2000.csv,2000,0.9608639313599221,0.03913606864007787
1373,Like Mike,62274780,51432760,10842020,2002.csv,2002,0.8259003082788892,0.17409969172111087
1374,Honey,62228395,30308417,31919978,2003.csv,2003,0.4870512408362774,0.5129487591637226
1375,28 Days,62198945,37170488,25028457,2000.csv,2000,0.5976064063466028,0.40239359365339716
1376,47 Meters Down,62187529,44307191,17880338,2017.csv,2017,0.7124771109654477,0.28752288903455225
1377,Two Brothers,62172050,19176754,42995296,2004.csv,2004,0.30844654470939914,0.6915534552906009
1378,Captain Corelli's Mandolin,62112895,25543895,36569000,2001.csv,2001,0.41124946760250025,0.5887505323974997
1379,White Snake,62098770,34730,62064040,2019.csv,2019,0.0005592703365944285,0.9994407296634056
1380,Brooklyn,62076141,38322743,23753398,2015.csv,2015,0.6173506017392415,0.3826493982607585
1381,Friday Night Lights,61950770,61255921,694849,2004.csv,2004,0.9887838520812574,0.011216147918742576
1382,"Dragon Ball Z: Resurrection ""F""",61768190,8008363,53759827,2015.csv,2015,0.1296518968744268,0.8703481031255732
1383,Valiant,61746888,19478106,42268782,2005.csv,2005,0.3154508126790131,0.6845491873209869
1384,"Everything, Everything",61621140,34121140,27500000,2017.csv,2017,0.5537245821807256,0.4462754178192744
1385,Woman in Gold,61619773,33307793,28311980,2015.csv,2015,0.540537418078447,0.459462581921553
1386,The Face Reader,61559184,515876,61043308,2013.csv,2013,0.008380163063889865,0.9916198369361101
1387,Krampus,61548707,42725475,18823232,2015.csv,2015,0.694173396688902,0.305826603311098
1388,Bombshell,61404394,31762808,29641586,2019.csv,2019,0.5172725587032094,0.48272744129679057
1389,A History of Violence,61385065,31504633,29880432,2005.csv,2005,0.5132296104923894,0.4867703895076107
1390,Ashfall,61354854,372562,60982292,2019.csv,2019,0.006072249801132279,0.9939277501988677
1391,In Good Company,61315215,45806659,15508556,2004.csv,2004,0.7470683907738072,0.2529316092261929
1392,The Legend of Hercules,61279452,18848538,42430914,2013.csv,2013,0.30758333152195944,0.6924166684780406
1393,Ma,61220784,45896028,15324756,2019.csv,2019,0.7496805006613441,0.250319499338656
1394,The Walk,61181942,10137502,51044440,2014.csv,2014,0.16569434817874856,0.8343056518212515
1395,Doraemon: Great Adventure in the Antarctic Kachi Kochi,61153455,0,61153455,2017.csv,2017,0.0,1.0
1396,Crossroads,61141030,37191304,23949726,2002.csv,2002,0.6082871682076668,0.39171283179233324
1397,Snatched,60845711,45852178,14993533,2017.csv,2017,0.7535811028652455,0.24641889713475448
1398,Kick-Ass 2,60795985,28795985,32000000,2013.csv,2013,0.4736494523445915,0.5263505476554085
1399,Zoolander,60780981,45172250,15608731,2001.csv,2001,0.7431971195068404,0.2568028804931595
1400,65,60730568,32062904,28667664,2023.csv,2023,0.5279533035159494,0.4720466964840507
1401,Taxi 2,60726164,626164,60100000,2000.csv,2000,0.010311272090231156,0.9896887279097688
1402,The Wild Thornberrys,60694737,40108697,20586040,2002.csv,2002,0.660826605114048,0.339173394885952
1403,Ron's Gone Wrong,60692022,23009270,37682752,2021.csv,2021,0.37911523198222,0.62088476801778
1404,Love You Forever,60670799,0,60670799,2020.csv,2020,0.0,1.0
1405,The Founding of an Army,60600361,0,60600361,2017.csv,2017,0.0,1.0
1406,21 Grams,60427839,16290476,44137363,2003.csv,2003,0.2695856126842464,0.7304143873157536
1407,My Little Pony: The Movie,60330833,21885107,38445726,2017.csv,2017,0.3627516132588456,0.6372483867411544
1408,The Perfect Guy,60273173,57027435,3245738,2015.csv,2015,0.9461495415215655,0.05385045847843451
1409,A Haunted House,60159584,40041683,20117901,2013.csv,2013,0.6655910885288037,0.33440891147119634
1410,The Crimson Rivers,60094966,594966,59500000,2001.csv,2001,0.009900429929521884,0.9900995700704781
1411,Beautiful Creatures,60052138,19452138,40600000,2013.csv,2013,0.323920823601651,0.676079176398349
1412,My Best Summer,60011073,0,60011073,2019.csv,2019,0.0,1.0
1413,Forever Young,59981902,149761,59832141,2015.csv,2015,0.0024967697756566637,0.9975032302243433
1414,Son of the Mask,59981548,17018422,42963126,2005.csv,2005,0.28372762236813226,0.7162723776318677
1415,Keeping the Faith,59945183,37047880,22897303,2000.csv,2000,0.6180293085434404,0.3819706914565596
1416,Adrift,59945012,31445012,28500000,2018.csv,2018,0.5245642790095696,0.47543572099043035
1417,Next Friday,59827328,57328603,2498725,2000.csv,2000,0.9582343874692181,0.04176561253078192
1418,Whitney Houston: I Wanna Dance with Somebody,59805300,23708080,36097220,2022.csv,2022,0.3964210529835984,0.6035789470164016
1419,Haunted Mansion,59620808,42020808,17600000,2023.csv,2023,0.7048010486540203,0.29519895134597973
1420,The Flintstones in Viva Rock Vegas,59468275,35268275,24200000,2000.csv,2000,0.5930603334298834,0.4069396665701166
1421,Miss Granny,59396311,234573,59161738,2015.csv,2015,0.003949285671967069,0.9960507143280329
1422,Molly's Game,59284015,28780744,30503271,2017.csv,2017,0.48547224745152634,0.5145277525484736
1423,Jeepers Creepers,59217789,37904175,21313614,2001.csv,2001,0.6400808885316539,0.3599191114683461
1424,Beast,59095809,31846530,27249279,2022.csv,2022,0.538896590788697,0.46110340921130294
1425,The Devotion of Suspect X,59035664,686435,58349229,2017.csv,2017,0.011627463019641822,0.9883725369803582
1426,The Gift,58978653,43787265,15191388,2015.csv,2015,0.742425653566554,0.257574346433446
1427,Miss Granny,58940254,0,58940254,2014.csv,2014,0.0,1.0
1428,Under the Tuscan Sun,58878723,43610723,15268000,2003.csv,2003,0.7406873107624974,0.25931268923750267
1429,A Walk Among the Tombstones,58834384,26307600,32526784,2014.csv,2014,0.44714668891578774,0.5528533110842122
1430,Shock Wave,58824459,0,58824459,2017.csv,2017,0.0,1.0
1431,Agent Cody Banks,58795814,47938330,10857484,2003.csv,2003,0.8153357652298172,0.1846642347701828
1432,Monster,58469210,34469210,24000000,2003.csv,2003,0.5895275479179555,0.4104724520820445
1433,Cloudy Mountain,58346882,0,58346882,2021.csv,2021,0.0,1.0
1434,Little Nicky,58292295,39464775,18827520,2000.csv,2000,0.6770152899281114,0.32298471007188856
1435,Must Love Dogs,58231520,43894863,14336657,2005.csv,2005,0.7537990249953976,0.2462009750046023
1436,Huo guo ying xiong,58106427,779818,57326609,2016.csv,2016,0.013420511985705126,0.9865794880142948
1437,L.O.R.D: Legend of Ravaging Dynasties,58089494,350456,57739038,2016.csv,2016,0.0060330358532646195,0.9939669641467354
1438,Doom,58072119,28212337,29859782,2005.csv,2005,0.4858155253470258,0.5141844746529741
1439,Bowling for Columbine,58008423,21576018,36432405,2002.csv,2002,0.3719462947648137,0.6280537052351862
1440,Avatar 2021 Re-release,57995770,0,57995770,2021.csv,2021,0.0,1.0
1441,Sky Captain and the World of Tomorrow,57947036,37762677,20184359,2004.csv,2004,0.6516757302306195,0.3483242697693804
1442,Snitch,57824674,42930462,14894212,2013.csv,2013,0.7424246265530179,0.25757537344698217
1443,Dolphin Tale 2,57824533,42024533,15800000,2014.csv,2014,0.7267595745217692,0.27324042547823085
1444,Nine Lives,57814445,19700032,38114413,2016.csv,2016,0.3407458464748732,0.6592541535251268
1445,Heartbreakers,57756408,40336607,17419801,2001.csv,2001,0.6983918909915589,0.3016081090084411
1446,Cellular,57678321,32003620,25674701,2004.csv,2004,0.5548639323256306,0.44513606767436936
1447,The Motorcycle Diaries,57663224,16781387,40881837,2004.csv,2004,0.2910240849523086,0.7089759150476914
1448,Goldbuster,57628292,186135,57442157,2017.csv,2017,0.0032299239408310073,0.996770076059169
1449,Ready or Not,57615777,28714231,28901546,2019.csv,2019,0.4983744469852416,0.5016255530147584
1450,Drumline,57588485,56399184,1189301,2002.csv,2002,0.9793482846440569,0.02065171535594312
1451,Nobody,57510518,27568035,29942483,2021.csv,2021,0.4793564022497589,0.520643597750241
1452,Derailed,57479076,36024076,21455000,2005.csv,2005,0.6267337352465443,0.3732662647534557
1453,Seven Dwarves,57410311,0,57410311,2004.csv,2004,0.0,1.0
1454,The Physician,57284237,0,57284237,2013.csv,2013,0.0,1.0
1455,Walking Tall,57223890,46437717,10786173,2004.csv,2004,0.8115092664969124,0.18849073350308762
1456,Jade Dynasty,57149764,0,57149764,2019.csv,2019,0.0,1.0
1457,Magic Mike's Last Dance,57105156,26005156,31100000,2023.csv,2023,0.4553906831109961,0.5446093168890038
1458,The 15:17 to Paris,57076286,36276286,20800000,2018.csv,2018,0.6355754472181319,0.36442455278186814
1459,The Descent,57051053,26024456,31026597,2005.csv,2005,0.45616083545381714,0.5438391645461829
1460,All the Money in the World,56996304,25113707,31882597,2017.csv,2017,0.44061992160053043,0.5593800783994696
1461,Elektra,56995646,24409722,32585924,2005.csv,2005,0.4282734509229003,0.5717265490770996
1462,Zoolander 2,56722693,28848693,27874000,2016.csv,2016,0.5085917377018754,0.4914082622981247
1463,Murder by Numbers,56714147,31945749,24768398,2002.csv,2002,0.5632765489711059,0.4367234510288941
1464,You Are My Sunshine,56640000,0,56640000,2015.csv,2015,0.0,1.0
1465,The Perfect Secret,56573047,0,56573047,2019.csv,2019,0.0,1.0
1466,Cradle 2 the Grave,56489558,34712347,21777211,2003.csv,2003,0.6144913897184325,0.3855086102815674
1467,The Big Sick,56411585,42873127,13538458,2017.csv,2017,0.7600057151381228,0.2399942848618772
1468,15 Minutes,56359980,24403552,31956428,2001.csv,2001,0.43299433392275866,0.5670056660772413
1469,Frida,56298474,25885000,30413474,2002.csv,2002,0.4597815564237141,0.5402184435762859
1470,A or B,56239049,0,56239049,2018.csv,2018,0.0,1.0
1471,Demon Slayer: Kimetsu No Yaiba - To the Swordsmith Village,56119404,10117806,46001598,2023.csv,2023,0.1802906887607003,0.8197093112392997
1472,Nezha Reborn,56088478,0,56088478,2021.csv,2021,0.0,1.0
1473,Kicking & Screaming,56070433,52842724,3227709,2005.csv,2005,0.9424347409623178,0.05756525903768212
1474,The Big Shot,56040681,0,56040681,2019.csv,2019,0.0,1.0
1475,Confidential Assignment,55972241,475618,55496623,2017.csv,2017,0.008497390697649572,0.9915026093023505
1476,Firestorm,55754766,0,55754766,2013.csv,2013,0.0,1.0
1477,Pay It Forward,55707411,33519628,22187783,2000.csv,2000,0.6017085949300355,0.3982914050699646
1478,All Eyez on Me,55668698,44922302,10746396,2017.csv,2017,0.806958014358446,0.1930419856415539
1479,The Lizzie McGuire Movie,55534455,42734455,12800000,2003.csv,2003,0.7695124585268731,0.23048754147312692
1480,Out of Time,55495563,41088845,14406718,2003.csv,2003,0.7403987414273101,0.25960125857268984
1481,Spanglish,55470154,42726869,12743285,2004.csv,2004,0.7702677191053048,0.2297322808946952
1482,Rugrats Go Wild,55250496,39402572,15847924,2003.csv,2003,0.7131623216558997,0.2868376783441003
1483,Dallas Buyers Club,55198285,27298285,27900000,2013.csv,2013,0.4945495136307224,0.5054504863692776
1484,The Mothman Prophecies,55157539,35746370,19411169,2002.csv,2002,0.6480776816384066,0.3519223183615933
1485,Hellboy,55064690,21903748,33160942,2019.csv,2019,0.39778209956325916,0.6022179004367408
1486,Barbershop: The Next Cut,55030051,54030051,1000000,2016.csv,2016,0.9818281106081476,0.018171889391852464
1487,Downsizing,55003890,24449754,30554136,2017.csv,2017,0.44450954287051336,0.5554904571294866
1488,Analyze That,55003135,32130627,22872508,2002.csv,2002,0.5841599210663174,0.4158400789336826
1489,The Whale,54932018,17463630,37468388,2022.csv,2022,0.3179134980986863,0.6820865019013137
1490,St. Vincent,54837234,44137712,10699522,2014.csv,2014,0.8048858190039272,0.19511418099607286
1491,Knock at the Cabin,54760947,35397980,19362967,2023.csv,2023,0.6464092010680531,0.3535907989319469
1492,Driven,54744738,32720065,22024673,2001.csv,2001,0.5976842011738187,0.40231579882618124
1493,The Punisher,54700105,33810189,20889916,2004.csv,2004,0.6181009890200394,0.38189901097996065
1494,Open Water,54683487,30610863,24072624,2004.csv,2004,0.5597825720221536,0.4402174279778464
1495,Go Brother!,54663060,0,54663060,2018.csv,2018,0.0,1.0
1496,"Good Night, and Good Luck.",54641191,31558003,23083188,2005.csv,2005,0.5775496914040545,0.4224503085959455
1497,The Hot Chick,54639553,35081594,19557959,2002.csv,2002,0.6420549231067099,0.3579450768932901
1498,Early Man,54622814,8267544,46355270,2018.csv,2018,0.15135697695838227,0.8486430230416178
1499,The Age of Shadows,54491162,541719,53949443,2016.csv,2016,0.009941410315309481,0.9900585896846905
1500,Confidential Assignment 2: International,54486330,0,54486330,2022.csv,2022,0.0,1.0
1501,Les Misérables,54465930,330181,54135749,2019.csv,2019,0.006062156654627948,0.993937843345372
1502,No Escape,54418872,27288872,27130000,2015.csv,2015,0.5014597141962075,0.4985402858037925
1503,No Good Deed,54323210,52543632,1779578,2014.csv,2014,0.9672409270365282,0.03275907296347178
1504,Upcoming,54300000,0,54300000,2021.csv,2021,0.0,1.0
1505,Mummies,54275970,4275970,50000000,2023.csv,2023,0.07878200979181026,0.9212179902081897
1506,Domestic Disturbance,54249294,45246095,9003199,2001.csv,2001,0.8340402549754841,0.1659597450245159
1507,"I, Tonya",53939297,30014539,23924758,2017.csv,2017,0.5564503185868366,0.4435496814131634
1508,Peppermint,53918723,35418723,18500000,2018.csv,2018,0.6568909838610235,0.34310901613897643
1509,Long Shot,53873809,30316271,23557538,2019.csv,2019,0.5627274470234692,0.4372725529765308
1510,1987: When the Day Comes,53834292,0,53834292,2017.csv,2017,0.0,1.0
1511,Don't Breathe 2,53785551,32712950,21072601,2021.csv,2021,0.6082107441829498,0.3917892558170502
1512,Overheard 3,53493428,0,53493428,2014.csv,2014,0.0,1.0
1513,The Cat Returns,53452652,0,53452652,2002.csv,2002,0.0,1.0
1514,Bounce,53425292,36805288,16620004,2000.csv,2000,0.6889113118932508,0.31108868810674917
1515,Supercondriaque,53425036,0,53425036,2014.csv,2014,0.0,1.0
1516,A Madea Christmas,53396635,52543354,853281,2013.csv,2013,0.9840199480735069,0.01598005192649312
1517,Sinister 2,53329150,27740955,25588195,2015.csv,2015,0.5201837081596088,0.4798162918403912
1518,Æon Flux,53321673,25874337,27447336,2005.csv,2005,0.48524990954428604,0.514750090455714
1519,A Chinese Odyssey: Part Three,53306108,0,53306108,2016.csv,2016,0.0,1.0
1520,Radio,53293628,52333738,959890,2003.csv,2003,0.9819886535028165,0.01801134649718349
1521,3 Days to Kill,53260230,30697999,22562231,2014.csv,2014,0.5763775147046868,0.4236224852953132
1522,Pitch Black,53187659,39240659,13947000,2000.csv,2000,0.7377775171492319,0.26222248285076805
1523,Temptation: Confessions of a Marriage Counselor,53143144,51975354,1167790,2013.csv,2013,0.9780255756038823,0.021974424396117777
1524,Delivery Man,53120346,30664106,22456240,2013.csv,2013,0.5772572716299702,0.4227427283700298
1525,Big Fat Liar,52970014,48360547,4609467,2002.csv,2002,0.91297969073597,0.08702030926403002
1526,The Outlaws,52946454,0,52946454,2017.csv,2017,0.0,1.0
1527,Man in Love,52946097,0,52946097,2021.csv,2021,0.0,1.0
1528,Detective Conan: Sunflowers of Inferno,52920296,0,52920296,2015.csv,2015,0.0,1.0
1529,Pooh's Heffalump Movie,52858433,18098433,34760000,2005.csv,2005,0.34239442928624086,0.6576055707137591
1530,Prem Ratan Dhan Payo,52715771,4364639,48351132,2015.csv,2015,0.08279569694617575,0.9172043030538243
1531,Break Through the Darkness,52700000,0,52700000,2021.csv,2021,0.0,1.0
1532,Rurouni Kenshin Part II: Kyoto Inferno,52696176,0,52696176,2014.csv,2014,0.0,1.0
1533,Wild,52501541,37880356,14621185,2014.csv,2014,0.7215094124570554,0.2784905875429447
1534,Tunnel,52444295,568876,51875419,2016.csv,2016,0.010847242774452398,0.9891527572255476
1535,The Boy Next Door,52425855,35423380,17002475,2015.csv,2015,0.6756853083273511,0.3243146916726489
1536,Jesus Revolution,52417940,52102987,314953,2023.csv,2023,0.993991503672216,0.006008496327783961
1537,The Night Before,52395996,43047372,9348624,2015.csv,2015,0.8215775113808315,0.17842248861916854
1538,Dragonfly,52323400,30323400,22000000,2002.csv,2002,0.5795380269630797,0.4204619730369204
1539,Ambulance,52300984,22781115,29519869,2022.csv,2022,0.4355771776683972,0.5644228223316028
1540,Greenland,52300000,0,52300000,2020.csv,2020,0.0,1.0
1541,Hollywood Adventures,52265070,0,52265070,2015.csv,2015,0.0,1.0
1542,Plane,52228094,32111181,20116913,2023.csv,2023,0.6148258253498586,0.38517417465014137
1543,One Hour Photo,52223306,31597131,20626175,2002.csv,2002,0.6050388881929459,0.3949611118070541
1544,Tolo Tolo,52186426,0,52186426,2020.csv,2020,0.0,1.0
1545,Patriots Day,52185751,31886361,20299390,2016.csv,2016,0.6110166163940038,0.3889833836059962
1546,My Beloved Bodyguard,52165873,0,52165873,2016.csv,2016,0.0,1.0
1547,Elizabethtown,52164016,26850426,25313590,2005.csv,2005,0.51473080600236,0.48526919399764007
1548,The Finest Hours,52099090,27569558,24529532,2016.csv,2016,0.5291754232175648,0.47082457678243517
1549,Teen Titans GO! To the Movies,52090236,29790236,22300000,2018.csv,2018,0.5718967370391641,0.4281032629608359
1550,Hanging Up,51880044,36050230,15829814,2000.csv,2000,0.6948766273212875,0.3051233726787125
1551,Blue Crush,51843679,40390647,11453032,2002.csv,2002,0.7790852767219703,0.22091472327802972
1552,"Yo-kai Watch Movie: It's the Secret of Birth, Meow!",51838845,257343,51581502,2015.csv,2015,0.004964288845555876,0.9950357111544441
1553,Enough,51806184,40007742,11798442,2002.csv,2002,0.7722580377663022,0.2277419622336978
1554,Slender Man,51738549,30569484,21169065,2018.csv,2018,0.5908454061979975,0.4091545938020025
1555,Schemes in Antiques,51637422,36501,51600921,2021.csv,2021,0.0007068710750122265,0.9992931289249878
1556,Master,51636415,597251,51039164,2016.csv,2016,0.011566469128424194,0.9884335308715758
1557,Teenage Mutant Ninja Turtles: Mutant Mayhem,51573468,43073468,8500000,2023.csv,2023,0.8351865730650496,0.16481342693495035
1558,Breaking In,51411620,46840590,4571030,2018.csv,2018,0.9110895552406246,0.08891044475937541
1559,Cry Me a Sad River,51400614,0,51400614,2018.csv,2018,0.0,1.0
1560,I Spy,51386477,33561137,17825340,2002.csv,2002,0.6531122380699498,0.3468877619300502
1561,Hot Pursuit,51380201,34580201,16800000,2015.csv,2015,0.6730258022929883,0.3269741977070117
1562,Once Upon a Deadpool 2018 Re-release,51349833,6100309,45249524,2018.csv,2018,0.1187990036890675,0.8812009963109325
1563,Simmba,51329025,5102129,46226896,2018.csv,2018,0.09940046591572702,0.900599534084273
1564,The 100 Year-Old Man Who Climbed Out the Window and Disappeared,51167572,944193,50223379,2013.csv,2013,0.018452956884489263,0.9815470431155108
1565,Hollywood Homicide,51142659,30940691,20201968,2003.csv,2003,0.6049879221180111,0.3950120778819889
1566,Magic in the Moonlight,51029361,10539326,40490035,2014.csv,2014,0.20653454782629946,0.7934654521737006
1567,Talk to Her 2002 Re-release,51001550,9285469,41716081,2002.csv,2002,0.1820624863361996,0.8179375136638004
1568,Doraemon the Movie: Nobita and the Birth of Japan,50939840,0,50939840,2016.csv,2016,0.0,1.0
1569,Just Friends,50912434,32619671,18292763,2005.csv,2005,0.6407014640077903,0.3592985359922097
1570,Just Mercy,50901502,36001502,14900000,2019.csv,2019,0.7072777930993077,0.29272220690069223
1571,Unleashed,50871113,24537621,26333492,2005.csv,2005,0.4823488135594753,0.5176511864405247
1572,Vanguard,50866901,793525,50073376,2020.csv,2020,0.015600026429760288,0.9843999735702397
1573,Team America: World Police,50826898,32786074,18040824,2004.csv,2004,0.64505360921298,0.3549463907870199
1574,Son of a Rich,50803834,0,50803834,2019.csv,2019,0.0,1.0
1575,The Skulls,50802120,35046120,15756000,2000.csv,2000,0.6898554627247839,0.31014453727521607
1576,What a Girl Wants,50732139,36105433,14626706,2003.csv,2003,0.7116875754046168,0.2883124245953832
1577,Diary of a Mad Black Woman,50652203,50633099,19104,2005.csv,2005,0.9996228397015624,0.0003771602984375625
1578,Fever Pitch,50605163,42071069,8534094,2005.csv,2005,0.8313592231685925,0.1686407768314075
1579,The Jungle Book 2 2003 Re-release,50600160,0,50600160,2003.csv,2003,0.0,1.0
1580,You Got Served,50576805,40363810,10212995,2004.csv,2004,0.7980695894096118,0.20193041059038822
1581,Kingdom,50574061,0,50574061,2019.csv,2019,0.0,1.0
1582,The Himalayas,50544493,696717,49847776,2015.csv,2015,0.013784231647154914,0.9862157683528451
1583,Marry Me,50477597,22438180,28039417,2022.csv,2022,0.4445175946073661,0.5554824053926339
1584,Dragon Ball Z: Battle of Gods,50461371,2553002,47908369,2013.csv,2013,0.05059319533747904,0.9494068046625209
1585,About Last Night,50445860,48637684,1808176,2014.csv,2014,0.9641561071612219,0.03584389283877805
1586,Breakthrough,50444358,40713082,9731276,2019.csv,2019,0.8070889117074302,0.1929110882925698
1587,Brahmastra Part One: Shiva,50164785,7839108,42325677,2022.csv,2022,0.15626715035258298,0.843732849647417
1588,The Closet,50104745,6678894,43425851,2001.csv,2001,0.13329863269436856,0.8667013673056314
1589,National Security,50097949,36381186,13716763,2003.csv,2003,0.7262011065562783,0.2737988934437216
1590,The Replacements,50054511,44737059,5317452,2000.csv,2000,0.8937667775837427,0.10623322241625735
1591,Uncut Gems,50023780,50023780,0,2019.csv,2019,1.0,0.0
1592,Dearest 2014 Re-release,50000583,0,50000583,2014.csv,2014,0.0,1.0
1593,Family is Family,49954866,0,49954866,2018.csv,2018,0.0,1.0
1594,21 Bridges,49939757,28539757,21400000,2019.csv,2019,0.5714836978481894,0.42851630215181064
1595,The Wailing,49851770,786633,49065137,2016.csv,2016,0.015779439727014708,0.9842205602729853
1596,Luca,49750471,0,49750471,2021.csv,2021,0.0,1.0
1597,Raising Helen,49718611,37486512,12232099,2004.csv,2004,0.7539734366271817,0.24602656337281828
1598,The Boy and the Beast,49714378,490643,49223735,2015.csv,2015,0.009869237426645467,0.9901307625733545
1599,Two Is a Family,49619118,0,49619118,2016.csv,2016,0.0,1.0
1600,Song of Youth,49615508,0,49615508,2019.csv,2019,0.0,1.0
1601,Surprise,49567466,0,49567466,2015.csv,2015,0.0,1.0
1602,Death Wish,49562710,34017028,15545682,2018.csv,2018,0.6863431801852643,0.3136568198147357
1603,The Grudge,49511319,21221803,28289516,2019.csv,2019,0.4286252806151256,0.5713747193848744
1604,Fantasy Island,49447308,27309289,22138019,2020.csv,2020,0.5522907131769438,0.44770928682305616
1605,Capote,49327405,28750530,20576875,2005.csv,2005,0.5828510540945748,0.4171489459054252
1606,Trolls World Tour,49276818,450000,48826818,2020.csv,2020,0.009132083163324384,0.9908679168366756
1607,Entourage,49263404,32363404,16900000,2015.csv,2015,0.6569461582476112,0.34305384175238884
1608,The Banshees of Inisherin,49262687,10582266,38680421,2022.csv,2022,0.2148130084743449,0.7851869915256551
1609,The New Mutants,49169594,23852659,25316935,2020.csv,2020,0.4851099441659006,0.5148900558340994
1610,Belfast,49158343,9250870,39907473,2021.csv,2021,0.18818514692409385,0.8118148530759062
1611,Little,48987096,40860481,8126615,2019.csv,2019,0.8341070268790786,0.16589297312092147
1612,Whiplash,48982041,13092000,35890041,2014.csv,2014,0.2672816349159481,0.732718365084052
1613,Never Gone,48980792,96421,48884371,2016.csv,2016,0.0019685471806989156,0.9980314528193011
1614,The Berlin File,48972848,665210,48307638,2013.csv,2013,0.013583241064518036,0.986416758935482
1615,Luck-Key,48913975,466505,48447470,2016.csv,2016,0.00953725392385305,0.9904627460761469
1616,Florence Foster Jenkins,48902953,27383770,21519183,2016.csv,2016,0.559961481262696,0.44003851873730404
1617,The Woman in Black 2: Angel of Death,48854305,26501323,22352982,2015.csv,2015,0.5424562482262311,0.457543751773769
1618,Bleeding Steel,48825526,0,48825526,2017.csv,2017,0.0,1.0
1619,Isn't It Romantic,48791187,48791187,0,2019.csv,2019,1.0,0.0
1620,Mother's Day,48782670,32492859,16289811,2016.csv,2016,0.6660738126879894,0.33392618731201057
1621,Missing,48767848,32502025,16265823,2023.csv,2023,0.6664642040386937,0.33353579596130634
1622,Concussion,48623572,34542474,14081098,2015.csv,2015,0.7104059323325732,0.28959406766742685
1623,Fat Albert,48551322,48116322,435000,2004.csv,2004,0.9910404087452037,0.008959591254796317
1624,Her,48517427,25568251,22949176,2013.csv,2013,0.5269910747740189,0.47300892522598115
1625,The Legend of Hei,48507082,0,48507082,2019.csv,2019,0.0,1.0
1626,Logan Lucky,48453605,27780977,20672628,2017.csv,2017,0.5733521169374292,0.4266478830625709
1627,Homefront,48449416,20158898,28290518,2013.csv,2013,0.4160813414138986,0.5839186585861015
1628,Chef,48428048,31424003,17004045,2014.csv,2014,0.6488802315550691,0.3511197684449309
1629,Boo 2! A Madea Halloween,48333932,47319572,1014360,2017.csv,2017,0.979013501322425,0.020986498677575
1630,The Last Stand,48330757,12050299,36280458,2013.csv,2013,0.24932982117370933,0.7506701788262907
1631,Secondhand Lions,48249017,42070939,6178078,2003.csv,2003,0.8719543239606311,0.12804567603936884
1632,Boyhood,48137666,25352281,22785385,2014.csv,2014,0.5266620321807874,0.4733379678192125
1633,21 & Over,48065672,25682380,22383292,2013.csv,2013,0.5343185465086184,0.4656814534913815
1634,Sky Hunter,48065601,0,48065601,2017.csv,2017,0.0,1.0
1635,Countdown,48021766,25621766,22400000,2019.csv,2019,0.5335448513076341,0.4664551486923659
1636,After We Collided,47990414,2386483,45603931,2020.csv,2020,0.04972832699463689,0.9502716730053631
1637,"From Today, It's My Turn: The Movie",47895887,0,47895887,2020.csv,2020,0.0,1.0
1638,Midsommar,47863365,27426361,20437004,2019.csv,2019,0.5730136399728686,0.4269863600271314
1639,Queen & Slim,47834125,43808310,4025815,2019.csv,2019,0.915838013133929,0.08416198686607103
1640,Phantom Thread,47756590,21198205,26558385,2017.csv,2017,0.4438802058522185,0.5561197941477815
1641,Book of Shadows: Blair Witch 2,47737094,26437094,21300000,2000.csv,2000,0.5538061030694496,0.4461938969305505
1642,"Yo-kai Watch Movie: It's the Secret of Birth, Meow! 2016 Re-release",47642462,0,47642462,2016.csv,2016,0.0,1.0
1643,Inside Men,47616503,0,47616503,2015.csv,2015,0.0,1.0
1644,The Dead End,47600000,0,47600000,2015.csv,2015,0.0,1.0
1645,Coming Home,47587984,377607,47210377,2014.csv,2014,0.007934923236084135,0.9920650767639159
1646,47 Meters Down: Uncaged,47582563,22260900,25321663,2019.csv,2019,0.46783734621441053,0.5321626537855895
1647,Boonie Bears: A Mystical Winter,47581416,0,47581416,2015.csv,2015,0.0,1.0
1648,A Walk to Remember,47494916,41281092,6213824,2002.csv,2002,0.8691686495455639,0.130831350454436
1649,Darkness Falls,47488536,32551396,14937140,2003.csv,2003,0.685457980848262,0.314542019151738
1650,Beauty and the Beast,47430624,0,47430624,2014.csv,2014,0.0,1.0
1651,The Magic Tuche,47427990,0,47427990,2018.csv,2018,0.0,1.0
1652,Nightcrawler,47426966,32381217,15045749,2014.csv,2014,0.6827596140136816,0.31724038598631843
1653,Almost Famous,47383689,32534850,14848839,2000.csv,2000,0.6866255179076496,0.31337448209235036
1654,Rough Night,47347283,22105643,25241640,2017.csv,2017,0.466883031070653,0.533116968929347
1655,Texas Chainsaw,47340586,34341945,12998641,2013.csv,2013,0.7254228961170865,0.2745771038829135
1656,Broken Flowers,47329961,13744960,33585001,2005.csv,2005,0.29040716936149596,0.709592830638504
1657,A Monster Calls,47309313,3740823,43568490,2016.csv,2016,0.07907159843982516,0.9209284015601749
1658,Tiny Times 2.0,47289937,43788,47246149,2013.csv,2013,0.0009259475224084143,0.9990740524775916
1659,Golden Job,47287851,285795,47002056,2018.csv,2018,0.006043729921243407,0.9939562700787566
1660,Mortdecai,47275695,7696134,39579561,2015.csv,2015,0.16279261468287246,0.8372073853171276
1661,The Watcher,47267829,28946615,18321214,2000.csv,2000,0.612395695177792,0.3876043048222079
1662,Switch,47164301,0,47164301,2013.csv,2013,0.0,1.0
1663,High Fidelity,47126295,27287137,19839158,2000.csv,2000,0.5790214783487647,0.4209785216512353
1664,The Wedding Date,47096206,31726995,15369211,2005.csv,2005,0.6736635006225342,0.3263364993774658
1665,Land of the Dead,47074133,20700082,26374051,2005.csv,2005,0.4397336855890686,0.5602663144109313
1666,Dracula 2000,47053625,33022767,14030858,2000.csv,2000,0.7018113269700262,0.29818867302997376
1667,The Place Beyond the Pines,47052899,21403519,25649380,2013.csv,2013,0.45488204669387106,0.5451179533061289
1668,Son of Bigfoot,47046281,289308,46756973,2017.csv,2017,0.006149434000957483,0.9938505659990425
1669,Asteroid City,46952390,27786960,19165430,2023.csv,2023,0.5918114072574368,0.40818859274256325
1670,My Hero Academia: World Heroes' Mission,46940541,12271658,34668883,2021.csv,2021,0.261429837376608,0.738570162623392
1671,Parker,46922566,17616641,29305925,2013.csv,2013,0.3754406994706982,0.6245593005293019
1672,Mary Queen of Scots,46712809,16468499,30244310,2018.csv,2018,0.35254782044899075,0.6474521795510092
1673,Uncle Drew,46664414,42469946,4194468,2018.csv,2018,0.9101142039413588,0.08988579605864118
1674,Be with You,46616207,0,46616207,2004.csv,2004,0.0,1.0
1675,Three Seconds,46596415,0,46596415,2017.csv,2017,0.0,1.0
1676,Get Rich or Die Tryin',46563961,30985352,15578609,2005.csv,2005,0.6654363446443055,0.3345636553556945
1677,Torque,46546197,21215059,25331138,2003.csv,2003,0.45578501289804624,0.5442149871019538
1678,The Big Wedding,46522137,21819348,24702789,2013.csv,2013,0.4690100112984922,0.5309899887015078
1679,Asterix & Obelix: The Middle Kingdom,46497671,0,46497671,2023.csv,2023,0.0,1.0
1680,Badges of Fury,46495296,0,46495296,2013.csv,2013,0.0,1.0
1681,Risen,46432579,36880033,9552546,2016.csv,2016,0.7942706133122608,0.20572938668773924
1682,Acrimony,46403669,43549096,2854573,2018.csv,2018,0.9384838944523978,0.061516105547602284
1683,The French Dispatch,46333545,16124375,30209170,2021.csv,2021,0.348006503711296,0.651993496288704
1684,The Thousand Faces of Dunjia,46263237,124187,46139050,2017.csv,2017,0.002684356047113608,0.9973156439528864
1685,Asterix: The Secret of the Magic Potion,46217749,1271953,44945796,2018.csv,2018,0.027520877314903415,0.9724791226850966
1686,The Fog,46201432,29550869,16650563,2005.csv,2005,0.6396093740124765,0.3603906259875235
1687,The Battleship Island,46183383,1104957,45078426,2017.csv,2017,0.023925423566307388,0.9760745764336927
1688,Hanson and the Beast,46154323,0,46154323,2017.csv,2017,0.0,1.0
1689,Eddie the Eagle,46152800,15789389,30363411,2016.csv,2016,0.342111182853478,0.657888817146522
1690,Napoleon Dynamite,46118097,44540956,1577141,2004.csv,2004,0.9658021231882139,0.03419787681178606
1691,Into the Blue,46117696,18801234,27316462,2005.csv,2005,0.4076793862382024,0.5923206137617977
1692,The World's End,46089287,26004851,20084436,2013.csv,2013,0.5642276696534707,0.43577233034652935
1693,The Hunted,46061847,34244097,11817750,2003.csv,2003,0.7434373398009854,0.2565626601990146
1694,Let's Get Married,45972724,462918,45509806,2015.csv,2015,0.010069405502271303,0.9899305944977287
1695,Eight Legged Freaks,45867333,17322606,28544727,2002.csv,2002,0.37766760932012333,0.6223323906798767
1696,Gintama Live Action the Movie,45746967,0,45746967,2017.csv,2017,0.0,1.0
1697,Somewhere Only We Know,45737711,482341,45255370,2015.csv,2015,0.010545805407708313,0.9894541945922917
1698,Chasing the Dragon II: Wild Wild Bunch,45733356,196634,45536722,2019.csv,2019,0.004299575128490461,0.9957004248715096
1699,"McFarland, USA",45710059,44482410,1227649,2015.csv,2015,0.9731426949153577,0.026857305084642312
1700,Judy,45701880,24313888,21387992,2019.csv,2019,0.5320106743967644,0.4679893256032356
1701,Guilty of Mind,45698503,0,45698503,2017.csv,2017,0.0,1.0
1702,Earth to Echo,45681062,38934842,6746220,2014.csv,2014,0.8523191076424624,0.14768089235753756
1703,That Awkward Moment,45640143,26068955,19571188,2014.csv,2014,0.5711847791537376,0.42881522084626245
1704,The Fabelmans,45591248,17348945,28242303,2022.csv,2022,0.3805323556837049,0.6194676443162951
1705,Bajrangi Bhaijaan 2018 Re-release,45579004,0,45579004,2018.csv,2018,0.0,1.0
1706,Hero,45565534,88675,45476859,2015.csv,2015,0.0019460981188105905,0.9980539018811894
1707,Queen of the Damned,45479110,30336800,15142310,2002.csv,2002,0.6670491133181806,0.33295088668181944
1708,Love on the Cloud,45386560,271734,45114826,2014.csv,2014,0.005987102789900799,0.9940128972100992
1709,Barbarian,45352337,40842944,4509393,2022.csv,2022,0.9005697765916671,0.09943022340833285
1710,Good Boy,45312217,37667746,7644471,2003.csv,2003,0.8312933794433408,0.16870662055665914
1711,Tanhaji: The Unsung Warrior,45221814,0,45221814,2020.csv,2020,0.0,1.0
1712,In the Heights,45175167,29975167,15200000,2021.csv,2021,0.6635319577235874,0.33646804227641264
1713,Blair Witch,45173154,20777061,24396093,2016.csv,2016,0.4599426686035693,0.5400573313964308
1714,Flatliners,45158254,16883115,28275139,2017.csv,2017,0.3738655396198445,0.6261344603801555
1715,Boonie Bears: The Big Top Secret,45150390,0,45150390,2016.csv,2016,0.0,1.0
1716,Deuce Bigalow: European Gigolo,45109561,22400154,22709407,2005.csv,2005,0.49657220117925777,0.5034277988207423
1717,Love Will Tear Us Apart,45060290,0,45060290,2021.csv,2021,0.0,1.0
1718,Monster's Ball,44909486,31273922,13635564,2001.csv,2001,0.6963767521186949,0.30362324788130507
1719,Grudge Match,44907260,29807260,15100000,2013.csv,2013,0.6637514735924659,0.3362485264075341
1720,Child's Play,44907074,29208403,15698671,2019.csv,2019,0.6504187513976083,0.3495812486023917
1721,Still Alice,44779195,18754371,26024824,2015.csv,2015,0.41881885103115407,0.5811811489688459
1722,The White Storm,44670277,0,44670277,2013.csv,2013,0.0,1.0
1723,Prey for the Devil,44658929,19802293,24856636,2022.csv,2022,0.44341173072018814,0.5565882692798119
1724,Richard Jewell,44655962,22345542,22310420,2019.csv,2019,0.5003932509616521,0.4996067490383479
1725,Uptown Girls,44617342,37182494,7434848,2003.csv,2003,0.8333641658886807,0.16663583411131933
1726,The Gift,44567606,12008642,32558964,2000.csv,2000,0.2694477688570483,0.7305522311429516
1727,Bad Genius,44560421,0,44560421,2017.csv,2017,0.0,1.0
1728,Mother!,44516999,17800004,26716995,2017.csv,2017,0.3998473482006278,0.6001526517993722
1729,Recess: School's Out,44460850,36706141,7754709,2001.csv,2001,0.8255834290167642,0.17441657098323582
1730,Oculus,44446287,27695246,16751041,2014.csv,2014,0.6231172021185931,0.37688279788140683
1731,A Man Apart,44350926,26736098,17614828,2003.csv,2003,0.6028306601760693,0.3971693398239306
1732,Dark Water 2005 Re-release,44347079,25473352,18873727,2005.csv,2005,0.5744087902610227,0.4255912097389774
1733,Unhinged,44331465,20831465,23500000,2020.csv,2020,0.4699024722056896,0.5300975277943104
1734,Hardball,44102389,40222729,3879660,2001.csv,2001,0.912030615847137,0.08796938415286301
1735,Tarzan,44095996,0,44095996,2013.csv,2013,0.0,1.0
1736,The Great Hypnotist,44077818,0,44077818,2014.csv,2014,0.0,1.0
1737,Winchester,44019588,25091816,18927772,2018.csv,2018,0.5700147852360635,0.4299852147639365
1738,Kick,43996483,2472695,41523788,2014.csv,2014,0.056202105972879696,0.9437978940271203
1739,Wind River,43980821,33800859,10179962,2017.csv,2017,0.7685363354176585,0.23146366458234147
1740,Max,43967255,42656255,1311000,2015.csv,2015,0.9701823550276223,0.029817644972377738
1741,The End of Endless Love,43950000,0,43950000,2020.csv,2020,0.0,1.0
1742,Timeline,43935763,19481943,24453820,2003.csv,2003,0.4434187930228957,0.5565812069771042
1743,The Transporter,43928932,25296447,18632485,2002.csv,2002,0.5758493514023969,0.42415064859760304
1744,Battle of Memories,43892362,594552,43297810,2017.csv,2017,0.01354568250393998,0.98645431749606
1745,Café Society,43763247,11103205,32660042,2016.csv,2016,0.25371072215002693,0.746289277849973
1746,The DUFF,43709744,34030343,9679401,2015.csv,2015,0.7785527867653491,0.22144721323465083
1747,The Sea Inside,43685449,2104923,41580526,2004.csv,2004,0.04818361830274424,0.9518163816972558
1748,League of Gods,43498766,181633,43317133,2016.csv,2016,0.004175589716728976,0.9958244102832711
1749,Secretly Greatly,43447199,0,43447199,2013.csv,2013,0.0,1.0
1750,The Master of Disguise,43411001,40388794,3022207,2002.csv,2002,0.9303815408449116,0.06961845915508837
1751,The War with Grandpa,43387638,21277892,22109746,2020.csv,2020,0.49041369802154244,0.5095863019784576
1752,In the Bedroom,43368779,35930604,7438175,2001.csv,2001,0.8284900988335411,0.17150990116645895
1753,Harriet,43347017,43082155,264862,2019.csv,2019,0.9938897294824232,0.006110270517576792
1754,Orange County,43325009,41076018,2248991,2002.csv,2002,0.94809023582661,0.051909764173390015
1755,The Snowman,43155261,6700035,36455226,2017.csv,2017,0.1552541878961177,0.8447458121038823
1756,A Shaun the Sheep Movie: Farmageddon,43100248,0,43100248,2019.csv,2019,0.0,1.0
1757,Annihilation,43070915,32732301,10338614,2018.csv,2018,0.7599629819798349,0.2400370180201651
1758,See Spot Run,43057552,33357476,9700076,2001.csv,2001,0.7747183583497733,0.22528164165022665
1759,Gifted,43046590,24801212,18245378,2017.csv,2017,0.5761481223019059,0.42385187769809407
1760,The Possession of Hannah Grace,43016528,14837422,28179106,2018.csv,2018,0.3449237465190124,0.6550762534809876
1761,Legend,42972994,1872994,41100000,2015.csv,2015,0.04358537364187378,0.9564146263581262
1762,"The Chef, The Actor, The Scoundrel",42970000,0,42970000,2013.csv,2013,0.0,1.0
1763,The Gallows,42964410,22764410,20200000,2015.csv,2015,0.5298434215668271,0.47015657843317293
1764,A Lot Like Love,42886719,21845719,21041000,2005.csv,2005,0.5093819137808141,0.49061808621918596
1765,Asterix and Obelix: Mansion of the Gods,42830578,0,42830578,2014.csv,2014,0.0,1.0
1766,Basic,42792561,26793311,15999250,2003.csv,2003,0.6261207643076094,0.37387923569239057
1767,Shaolin Soccer,42776760,489600,42287160,2001.csv,2001,0.01144546711812676,0.9885545328818732
1768,Doraemon: Nobita's Secret Gadget Museum,42770271,0,42770271,2013.csv,2013,0.0,1.0
1769,Spirit Untamed,42717215,17716215,25001000,2021.csv,2021,0.4147324445191476,0.5852675554808524
1770,Peninsula,42698327,1231407,41466920,2020.csv,2020,0.02883970137752704,0.971160298622473
1771,Almost Christmas,42580920,42158780,422140,2016.csv,2016,0.9900861700498721,0.009913829950127897
1772,Oliver Twist,42580321,2080321,40500000,2005.csv,2005,0.04885639542266485,0.9511436045773352
1773,Paws of Fury: The Legend of Hank,42506565,17811382,24695183,2022.csv,2022,0.4190266138889369,0.5809733861110631
1774,Thermae Romae II,42473163,0,42473163,2014.csv,2014,0.0,1.0
1775,Love the Coopers,42426912,26302731,16124181,2015.csv,2015,0.6199539339558816,0.3800460660441184
1776,8 Women,42426583,3098776,39327807,2002.csv,2002,0.0730385475540182,0.9269614524459818
1777,Loving Vincent,42187665,6735118,35452547,2017.csv,2017,0.15964661708582353,0.8403533829141765
1778,The Throne,42165755,0,42165755,2015.csv,2015,0.0,1.0
1779,Monster Hunter,42145959,15162470,26983489,2020.csv,2020,0.3597609441037989,0.6402390558962011
1780,Long Day's Journey Into Night,42140994,521365,41619629,2018.csv,2018,0.01237191984602926,0.9876280801539707
1781,Jobs,42128352,16131410,25996942,2013.csv,2013,0.3829110144161348,0.6170889855838653
1782,Bang Bang,42045981,2546172,39499809,2014.csv,2014,0.060556846087144456,0.9394431539128556
1783,Detective Conan: The Sniper from Another Dimension,42028116,0,42028116,2014.csv,2014,0.0,1.0
1784,The Sisterhood of the Traveling Pants,42013878,39053061,2960817,2005.csv,2005,0.9295276432230322,0.07047235677696784
1785,Mary and the Witch's Flower,41978431,2418404,39560027,2017.csv,2017,0.05761063342267366,0.9423893665773263
1786,Resident Evil: Welcome to Raccoon City,41914915,17000612,24914303,2021.csv,2021,0.40559815044358316,0.5944018495564168
1787,Rurouni Kenshin: The Legend Ends,41900000,0,41900000,2014.csv,2014,0.0,1.0
1788,"As Above, So Below",41898409,21321100,20577309,2014.csv,2014,0.5088761246280259,0.49112387537197416
1789,Call Me by Your Name,41887595,18095701,23791894,2017.csv,2017,0.4320062061333433,0.5679937938666567
1790,No Man's Land,41807712,0,41807712,2013.csv,2013,0.0,1.0
1791,Wimbledon,41682237,17001133,24681104,2004.csv,2004,0.4078747740914193,0.5921252259085806
1792,T2 Trainspotting,41681746,2402004,39279742,2017.csv,2017,0.05762724047116452,0.9423727595288355
1793,Overlord,41657844,21704844,19953000,2018.csv,2018,0.5210265802522089,0.47897341974779106
1794,Undercover Brother,41604473,39089928,2514545,2002.csv,2002,0.9395607054078056,0.06043929459219445
1795,The Great Battle,41509280,472166,41037114,2018.csv,2018,0.0113749503725432,0.9886250496274568
1796,Fighting with My Family,41503392,22958886,18544506,2019.csv,2019,0.55318095446271,0.44681904553729007
1797,Lupin III vs. Detective Conan: The Movie,41397727,0,41397727,2013.csv,2013,0.0,1.0
1798,The Lady in the Van,41387687,10021175,31366512,2015.csv,2015,0.24212938017048405,0.757870619829516
1799,Ricki and the Flash,41325328,26822144,14503184,2015.csv,2015,0.6490485447568619,0.35095145524313803
1800,Pinocchio,41314585,3675719,37638866,2002.csv,2002,0.08896904083630515,0.9110309591636948
1801,This Is Where I Leave You,41296320,34296320,7000000,2014.csv,2014,0.8304933708378858,0.1695066291621142
1802,The Darkest Minds,41142379,12695691,28446688,2018.csv,2018,0.30857940908084097,0.6914205909191591
1803,Fist Fight,41087017,32187017,8900000,2017.csv,2017,0.7833865622320549,0.21661343776794503
1804,Whale Rider,41062976,20779666,20283310,2003.csv,2003,0.5060438386151067,0.4939561613848933
1805,"Lost, Found",41043552,0,41043552,2018.csv,2018,0.0,1.0
1806,Twisted,40954603,25198598,15756005,2004.csv,2004,0.6152812175959806,0.3847187824040194
1807,Underwater,40882928,17291078,23591850,2020.csv,2020,0.4229412824834855,0.5770587175165145
1808,Where the Heart Is,40863718,33772838,7090880,2000.csv,2000,0.8264749184105078,0.17352508158949217
1809,The Circle,40656399,20497844,20158555,2017.csv,2017,0.504172639588666,0.495827360411334
1810,Spiral,40618920,23216862,17402058,2021.csv,2021,0.571577530864927,0.42842246913507304
1811,Spanish Affair 2,40591862,0,40591862,2015.csv,2015,0.0,1.0
1812,Holmes & Watson,40466970,30573626,9893344,2018.csv,2018,0.7555205146320567,0.24447948536794328
1813,Serenity,40445129,25514517,14930612,2005.csv,2005,0.6308427647739732,0.36915723522602684
1814,Bless the Child,40443010,29381494,11061516,2000.csv,2000,0.7264912774790996,0.2735087225209004
1815,The Ringer,40442443,35428675,5013768,2005.csv,2005,0.8760270738342884,0.12397292616571161
1816,The Witch,40423945,25138705,15285240,2016.csv,2016,0.6218765882449128,0.37812341175508724
1817,The Art of War,40400425,30208599,10191826,2000.csv,2000,0.7477297330411747,0.2522702669588253
1818,Masquerade Hotel,40396244,0,40396244,2019.csv,2019,0.0,1.0
1819,80 for Brady,40362938,39330588,1032350,2023.csv,2023,0.9744233187385913,0.025576681261408673
1820,Bad Education,40350837,5211842,35138995,2004.csv,2004,0.12916316952731366,0.8708368304726863
1821,Magnificent Desolation: Walking on the Moon,40339402,34137524,6201878,2005.csv,2005,0.8462575622712504,0.15374243772874968
1822,Carol,40272135,12711491,27560644,2015.csv,2015,0.3156398586764769,0.6843601413235231
1823,Yolki 3,40267368,0,40267368,2013.csv,2013,0.0,1.0
1824,Boonie Bears: To the Rescue,40163675,0,40163675,2014.csv,2014,0.0,1.0
1825,Crimson Rivers 2: Angels of the Apocalypse,40152148,152148,40000000,2004.csv,2004,0.0037892866902164237,0.9962107133097836
1826,"Ruby Gillman, Teenage Kraken",40148338,15696610,24451728,2023.csv,2023,0.39096537445709456,0.6090346255429054
1827,Diary of a Wimpy Kid: The Long Haul,40140972,20738724,19402248,2017.csv,2017,0.5166472799911273,0.48335272000887275
1828,The Wild Life,40075446,8005586,32069860,2016.csv,2016,0.19976286726790266,0.8002371327320974
1829,Snake Eyes,40064325,28264325,11800000,2021.csv,2021,0.7054736352103773,0.2945263647896227
1830,Northern Limit Line,40034677,337907,39696770,2015.csv,2015,0.008440357842777151,0.9915596421572228
1831,Dancer in the Dark,40031879,4184036,35847843,2000.csv,2000,0.10451760208407904,0.895482397915921
1832,Black Knight,39976235,33426971,6549264,2001.csv,2001,0.8361710651340728,0.16382893486592723
1833,Love O2O,39969537,0,39969537,2016.csv,2016,0.0,1.0
1834,Brotherhood of Blades 2,39966092,14204,39951888,2017.csv,2017,0.0003554012736596813,0.9996445987263404
1835,Bloodshot,39861118,12561824,27299294,2020.csv,2020,0.315139781076888,0.684860218923112
1836,The Last Wish,39756292,0,39756292,2019.csv,2019,0.0,1.0
1837,Midnight Runners,39730433,0,39730433,2017.csv,2017,0.0,1.0
1838,Memento,39723096,25544867,14178229,2001.csv,2001,0.6430734150228371,0.3569265849771629
1839,Tokyo Revengers,39714073,0,39714073,2021.csv,2021,0.0,1.0
1840,The Forest,39712000,26594261,13117739,2016.csv,2016,0.6696782080983078,0.3303217919016922
1841,The November Man,39661919,25018119,14643800,2014.csv,2014,0.6307843803523475,0.3692156196476524
1842,Nightmare Alley,39629195,11338107,28291088,2021.csv,2021,0.2861049032159245,0.7138950967840755
1843,Intimate Strangers,39576060,0,39576060,2018.csv,2018,0.0,1.0
1844,Thugs of Hindostan,39570044,1449848,38120196,2018.csv,2018,0.0366400401273246,0.9633599598726754
1845,Recep Ivedik 4,39477906,0,39477906,2014.csv,2014,0.0,1.0
1846,Down with Love,39468111,20305251,19162860,2003.csv,2003,0.5144723293192319,0.4855276706807681
1847,The Legend of Bagger Vance,39459427,30919168,8540259,2000.csv,2000,0.7835686007300613,0.2164313992699387
1848,Nomadland,39458207,3700000,35758207,2021.csv,2021,0.09377009958916785,0.9062299004108322
1849,Don Jon,39439355,24477704,14961651,2013.csv,2013,0.6206415901071405,0.37935840989285957
1850,Crocodile Dundee in Los Angeles,39438674,25635682,13802992,2001.csv,2001,0.6500137910316153,0.34998620896838467
1851,King Richard,39429285,15129285,24300000,2021.csv,2021,0.38370680574096133,0.6162931942590387
1852,Sin City: A Dame to Kill For,39407616,13757804,25649812,2014.csv,2014,0.3491153588179503,0.6508846411820497
1853,Uri: The Surgical Strike,39346577,4186168,35160409,2019.csv,2019,0.10639217739322025,0.8936078226067797
1854,Otoko-tachi no Yamato,39287114,0,39287114,2005.csv,2005,0.0,1.0
1855,The Gambler,39280992,33680992,5600000,2014.csv,2014,0.8574374089126874,0.14256259108731267
1856,Dumb and Dumberer: When Harry Met Lloyd,39267515,26276465,12991050,2003.csv,2003,0.6691654666713694,0.33083453332863055
1857,Absolutely Fabulous: The Movie,39219109,4772155,34446954,2016.csv,2016,0.12167933238870877,0.8783206676112912
1858,My Mom Is a Character 2,39195565,0,39195565,2016.csv,2016,0.0,1.0
1859,Sink or Swim,39193850,0,39193850,2018.csv,2018,0.0,1.0
1860,Samba,39178695,151530,39027165,2014.csv,2014,0.0038676632797493638,0.9961323367202506
1861,Show Dogs,39156854,17857020,21299834,2018.csv,2018,0.4560381689499366,0.5439618310500635
1862,Women Who Flirt,39156132,375495,38780637,2014.csv,2014,0.009589685722787941,0.990410314277212
1863,Masterpiece Mystery: Sherlock: The Abominable Bride,39139204,0,39139204,2016.csv,2016,0.0,1.0
1864,Ex-Files 2: The Backup Strikes Back,39108291,0,39108291,2015.csv,2015,0.0,1.0
1865,Haunted Castle,39093166,13651656,25441510,2001.csv,2001,0.3492082478047442,0.6507917521952559
1866,Believer,39047153,365639,38681514,2018.csv,2018,0.009364037372968011,0.990635962627032
1867,The Life of David Gale,38955598,19955598,19000000,2003.csv,2003,0.512265220521066,0.48773477947893396
1868,Forbidden Empire 2014 Re-release,38885962,0,38885962,2014.csv,2014,0.0,1.0
1869,The Spy Gone North,38844509,500803,38343706,2018.csv,2018,0.012892504317663018,0.987107495682337
1870,Criminal,38803993,14708696,24095297,2015.csv,2015,0.3790510940459143,0.6209489059540857
1871,Clockstoppers,38793283,36989956,1803327,2002.csv,2002,0.9535144524891075,0.046485547510892546
1872,Dreamer,38741732,32751093,5990639,2005.csv,2005,0.8453698714347618,0.15463012856523814
1873,Antoine and Sebastian,38719881,0,38719881,2013.csv,2013,0.0,1.0
1874,Someone Like You,38689940,27343067,11346873,2001.csv,2001,0.7067229103999645,0.29327708960003557
1875,On the Basis of Sex,38673750,24622687,14051063,2018.csv,2018,0.6366769966708685,0.36332300332913153
1876,"Crouching Tiger, Hidden Dragon: Sword of Destiny",38659039,0,38659039,2016.csv,2016,0.0,1.0
1877,Head of State,38620484,38125247,495237,2003.csv,2003,0.987176830823767,0.012823169176233006
1878,The Best of Me,38609668,26766213,11843455,2014.csv,2014,0.6932515710831805,0.30674842891681947
1879,Taxi 5,38598227,0,38598227,2018.csv,2018,0.0,1.0
1880,Urban Legends: Final Cut,38574362,21468807,17105555,2000.csv,2000,0.5565563728571843,0.44344362714281577
1881,Always: Sunset on Third Street,38573583,0,38573583,2005.csv,2005,0.0,1.0
1882,Million Dollar Arm,38483455,36457627,2025828,2014.csv,2014,0.9473584687237672,0.05264153127623286
1883,What's the Worst That Could Happen?,38464131,32269834,6194297,2001.csv,2001,0.8389591331206728,0.16104086687932714
1884,The Missing,38364277,27011180,11353097,2003.csv,2003,0.7040711336746943,0.2959288663253057
1885,Boruto: Naruto The Movie,38362448,919651,37442797,2015.csv,2015,0.023972688082887723,0.9760273119171122
1886,The Lazarus Effect,38356892,25801570,12555322,2015.csv,2015,0.6726710287162996,0.3273289712837005
1887,National Lampoon's Van Wilder,38275483,21305259,16970224,2002.csv,2002,0.5566293964206801,0.44337060357931996
1888,The Original Kings of Comedy,38182790,38182790,0,2000.csv,2000,1.0,0.0
1889,The Water Diviner,38176317,4196641,33979676,2014.csv,2014,0.10992786444014492,0.8900721355598551
1890,The Producers,38075318,19398532,18676786,2005.csv,2005,0.5094778722530958,0.4905221277469042
1891,The Banger Sisters,38068353,30307416,7760937,2002.csv,2002,0.7961315268879638,0.20386847311203612
1892,Arashi Anniversary Tour 5 x 20 Film: Record of Memories,38052695,0,38052695,2021.csv,2021,0.0,1.0
1893,But Always,38039248,430760,37608488,2014.csv,2014,0.011324093473141214,0.9886759065268588
1894,The Invitation,38036130,25100080,12936050,2022.csv,2022,0.6599009941337355,0.3400990058662645
1895,Overcomer,38026103,34746945,3279158,2019.csv,2019,0.9137656046426845,0.08623439535731547
1896,Helios,37938005,0,37938005,2015.csv,2015,0.0,1.0
1897,The King,37886707,0,37886707,2017.csv,2017,0.0,1.0
1898,Hell or High Water,37879877,27007844,10872033,2016.csv,2016,0.7129865812394269,0.28701341876057307
1899,Operation Fortune: Ruse de Guerre,37846956,6496125,31350831,2023.csv,2023,0.17164194129641497,0.828358058703585
1900,Cold Eyes,37795598,0,37795598,2013.csv,2013,0.0,1.0
1901,Mission Milano,37749848,0,37749848,2016.csv,2016,0.0,1.0
1902,Bulletproof Monk,37713879,23358708,14355171,2003.csv,2003,0.6193663611213261,0.3806336388786738
1903,The Handmaiden,37692886,2006788,35686098,2016.csv,2016,0.05324049742436809,0.9467595025756319
1904,Casanova,37691644,11304403,26387241,2005.csv,2005,0.2999180136584119,0.700081986341588
1905,The Yinyang Master,37690000,0,37690000,2021.csv,2021,0.0,1.0
1906,The Prince and Me,37666766,28176497,9490269,2004.csv,2004,0.7480466201956387,0.2519533798043612
1907,Halloween: Resurrection,37664855,30354442,7310413,2002.csv,2002,0.8059089036716058,0.1940910963283942
1908,Pokémon the Movie: I Choose You!,37552144,2401722,35150422,2017.csv,2017,0.06395698738266449,0.9360430126173355
1909,Fat Buddies,37496410,0,37496410,2018.csv,2018,0.0,1.0
1910,A Walk in the Woods,37461274,29504281,7956993,2015.csv,2015,0.7875941699153104,0.21240583008468958
1911,T-34,37410850,0,37410850,2019.csv,2019,0.0,1.0
1912,Sarileru Neekevvaru,37389889,821000,36568889,2020.csv,2020,0.021957807898279665,0.9780421921017204
1913,Pain and Glory,37359689,4567338,32792351,2019.csv,2019,0.12225310547954508,0.877746894520455
1914,Snowden,37357216,21587519,15769697,2016.csv,2016,0.5778674460109662,0.4221325539890339
1915,The Majestic,37317558,27807266,9510292,2001.csv,2001,0.7451523489291555,0.25484765107084445
1916,Home Again,37270721,27020284,10250437,2017.csv,2017,0.7249734718037786,0.27502652819622136
1917,Beauty Shop,37245453,36351350,894103,2005.csv,2005,0.9759943045933688,0.024005695406631247
1918,Pokémon: Lucario and the Mystery of Mew,37228626,0,37228626,2005.csv,2005,0.0,1.0
1919,"Like Father, Like Son",37170163,334616,36835547,2013.csv,2013,0.009002274216553745,0.9909977257834462
1920,A Witness Out of the Blue,37092694,0,37092694,2019.csv,2019,0.0,1.0
1921,Orphan: First Kill,37083743,5413227,31670516,2022.csv,2022,0.14597304808201264,0.8540269519179874
1922,Till The End Of The World,37013733,118660,36895073,2018.csv,2018,0.003205837141582018,0.9967941628584179
1923,Rurouni Kenshin: Final Chapter Part I - The Final,36964978,0,36964978,2021.csv,2021,0.0,1.0
1924,2.0,36945969,4152000,32793969,2018.csv,2018,0.11238032490093845,0.8876196750990616
1925,Devil's Due,36921560,15821461,21100099,2014.csv,2014,0.42851550692874296,0.571484493071257
1926,Ex Machina,36869414,25442958,11426456,2015.csv,2015,0.6900830590906598,0.3099169409093402
1927,The Adventurers,36796816,216556,36580260,2017.csv,2017,0.0058851831093211975,0.9941148168906788
1928,Titan A.E.,36754634,22753426,14001208,2000.csv,2000,0.6190627826684385,0.3809372173315615
1929,New Interpretation Records of the Three Kingdoms,36747486,0,36747486,2020.csv,2020,0.0,1.0
1930,Negotiator: Mashita Masayoshi,36733286,0,36733286,2005.csv,2005,0.0,1.0
1931,Valentine,36684136,20384136,16300000,2001.csv,2001,0.5556662422143457,0.44433375778565426
1932,Joy Ride,36642838,21974919,14667919,2001.csv,2001,0.5997057051094132,0.4002942948905868
1933,Return to Me,36609995,32722798,3887197,2000.csv,2000,0.8938214277275919,0.10617857227240812
1934,Burnt,36606743,13651946,22954797,2015.csv,2015,0.3729352813496683,0.6270647186503318
1935,The Intruder,36599361,35419122,1180239,2019.csv,2019,0.9677524697767265,0.03224753022327357
1936,The Priests,36577134,185093,36392041,2015.csv,2015,0.005060347265042691,0.9949396527349573
1937,Detective Conan: Private Eye in the Distant Sea,36324232,0,36324232,2013.csv,2013,0.0,1.0
1938,A Most Wanted Man,36233517,17237855,18995662,2014.csv,2014,0.4757433566275115,0.5242566433724886
1939,Ride On,36232675,128950,36103725,2023.csv,2023,0.00355894230828941,0.9964410576917105
1940,Nobunaga Concerto: The Movie,36187594,0,36187594,2016.csv,2016,0.0,1.0
1941,Dügün Dernek,36185741,0,36185741,2013.csv,2013,0.0,1.0
1942,The Confidence Man JP: Princess,36109913,0,36109913,2020.csv,2020,0.0,1.0
1943,The Door Lock,36100000,0,36100000,2021.csv,2021,0.0,1.0
1944,Nothing to Lose,36075317,1016188,35059129,2018.csv,2018,0.028168512005036575,0.9718314879949634
1945,Roald Dahl's Matilda the Musical,36029699,0,36029699,2022.csv,2022,0.0,1.0
1946,Kundo: Age of the Rampant,35941291,280958,35660333,2014.csv,2014,0.00781713711953196,0.9921828628804681
1947,Doraemon the Movie: The New Records of Nobita's Spaceblazer 2014 Re-release,35861856,0,35861856,2014.csv,2014,0.0,1.0
1948,Garden State,35825316,26782316,9043000,2004.csv,2004,0.747580733132961,0.2524192668670389
1949,The New Adventures of Aladdin,35771820,0,35771820,2015.csv,2015,0.0,1.0
1950,Heidi,35755670,0,35755670,2015.csv,2015,0.0,1.0
1951,Riding in Cars with Boys,35743308,30165536,5577772,2001.csv,2001,0.8439491946296632,0.15605080537033675
1952,"Tad, the Lost Explorer, and the Secret of King Midas",35704046,5874,35698172,2017.csv,2017,0.00016451916962016014,0.9998354808303799
1953,Doraemon the Movie: Nobita's Sky Utopia,35671492,0,35671492,2023.csv,2023,0.0,1.0
1954,Hostiles,35669017,29819114,5849903,2017.csv,2017,0.835994835517895,0.164005164482105
1955,The Terror Live,35659824,0,35659824,2013.csv,2013,0.0,1.0
1956,My Dog Skip,35547761,34134641,1413120,2000.csv,2000,0.9602472853353549,0.039752714664645125
1957,The Queen's Corgi,35515687,0,35515687,2019.csv,2019,0.0,1.0
1958,Jersey Girl,35492921,25268157,10224764,2004.csv,2004,0.7119210334928477,0.28807896650715226
1959,Mia and the White Lion,35487190,399471,35087719,2018.csv,2018,0.011256766173934877,0.9887432338260651
1960,Hide and Seek,35461505,0,35461505,2013.csv,2013,0.0,1.0
1961,Original Sin,35402320,16534221,18868099,2001.csv,2001,0.46703778170470184,0.5329622182952981
1962,Room,35401758,14677654,20724104,2015.csv,2015,0.4146024047732319,0.5853975952267682
1963,Namiya,35351623,70814,35280809,2017.csv,2017,0.0020031329254670996,0.997996867074533
1964,Assault on Precinct 13,35294470,20040895,15253575,2005.csv,2005,0.5678196896000989,0.4321803103999012
1965,Eye in the Sky,35259653,18704595,16555058,2016.csv,2016,0.5304815393390286,0.46951846066097136
1966,Les Tuche 2: The American Dream,35210425,0,35210425,2016.csv,2016,0.0,1.0
1967,Destiny: The Tale of Kamakura,35166640,0,35166640,2017.csv,2017,0.0,1.0
1968,The Girl in the Spider's Web,35164920,14841338,20323582,2018.csv,2018,0.42204953118050603,0.577950468819494
1969,The Adventures of Rocky & Bullwinkle,35134820,26005820,9129000,2000.csv,2000,0.7401722849298786,0.2598277150701213
1970,Alfie,35060882,13399812,21661070,2004.csv,2004,0.3821869626668262,0.6178130373331737
1971,The Liquidator,35046130,0,35046130,2017.csv,2017,0.0,1.0
1972,Flight of the Phoenix,35021497,21009180,14012317,2004.csv,2004,0.5998938309233326,0.4001061690766674
1973,We Made a Beautiful Bouquet,34975905,0,34975905,2021.csv,2021,0.0,1.0
1974,Kingdom II: Harukanaru Daichi e,34963395,0,34963395,2022.csv,2022,0.0,1.0
1975,Blind Detective,34958596,0,34958596,2013.csv,2013,0.0,1.0
1976,When Marnie Was There,34949567,561085,34388482,2014.csv,2014,0.016054133088401354,0.9839458669115987
1977,The Hate U Give,34934009,29719483,5214526,2018.csv,2018,0.8507321046376326,0.14926789536236737
1978,Lost and Love,34930177,188817,34741360,2015.csv,2015,0.005405555202311171,0.9945944447976889
1979,Malignant,34891791,13391791,21500000,2021.csv,2021,0.38380921747467767,0.6161907825253223
1980,Secret in Their Eyes,34854990,20180155,14674835,2015.csv,2015,0.578974631752871,0.42102536824712905
1981,"Dad, Where Are We Going 2",34840000,0,34840000,2015.csv,2015,0.0,1.0
1982,Kidnap,34814102,30971040,3843062,2017.csv,2017,0.8896119164584513,0.11038808354154876
1983,Doraemon: Nobita no uchuu eiyuuki,34811747,0,34811747,2015.csv,2015,0.0,1.0
1984,The Life Aquatic with Steve Zissou,34808403,24020403,10788000,2004.csv,2004,0.6900748362399735,0.30992516376002655
1985,Broken City,34737199,19701164,15036035,2013.csv,2013,0.5671488941868917,0.4328511058131083
1986,Endless Love,34718173,23438250,11279923,2014.csv,2014,0.6751003285800782,0.32489967141992177
1987,Nana,34671042,0,34671042,2005.csv,2005,0.0,1.0
1988,The Man Standing Next,34664900,113527,34551373,2020.csv,2020,0.003274984205925879,0.9967250157940741
1989,Malibu's Most Wanted,34622504,34432201,190303,2003.csv,2003,0.9945034882514563,0.005496511748543664
1990,R.A.I.D. Special Unit,34598750,0,34598750,2017.csv,2017,0.0,1.0
1991,Steve Jobs,34441873,17766658,16675215,2015.csv,2015,0.515844710303647,0.484155289696353
1992,Swimfan,34411240,28564995,5846245,2002.csv,2002,0.8301065291457094,0.16989347085429063
1993,My Mom is a Character 3,34360029,0,34360029,2020.csv,2020,0.0,1.0
1994,Pokémon the Movie: Destiny Deoxys,34337258,0,34337258,2004.csv,2004,0.0,1.0
1995,Warrior of the Hornor,34291831,0,34291831,2019.csv,2019,0.0,1.0
1996,The Medallion,34268701,22219192,12049509,2003.csv,2003,0.648381507078427,0.35161849292157293
1997,American Psycho,34266564,15070285,19196279,2000.csv,2000,0.43979562701413544,0.5602043729858646
1998,Wild Safari - A South African Adventure,34257135,16621530,17635605,2005.csv,2005,0.48519906874874386,0.5148009312512561
1999,Bad News Bears,34252847,32868349,1384498,2005.csv,2005,0.95958006060051,0.040419939399489915
2000,Victor Frankenstein,34227298,5775076,28452222,2015.csv,2015,0.16872719546836562,0.8312728045316343
2001,The House,34184504,25584504,8600000,2017.csv,2017,0.748424022767743,0.25157597723225705
2002,The Bob's Burgers Movie,34148750,31933830,2214920,2022.csv,2022,0.9351390607269666,0.06486093927303342
2003,The Battle: Roar to Victory,34148707,0,34148707,2019.csv,2019,0.0,1.0
2004,Black & White: The Dawn of Justice,34146896,0,34146896,2014.csv,2014,0.0,1.0
2005,The Bad Guys: The Movie,34024386,166972,33857414,2019.csv,2019,0.004907421400638942,0.9950925785993611
2006,"My Love, Don't Cross That River",34012261,0,34012261,2014.csv,2014,0.0,1.0
2007,Darkness,33988736,22163442,11825294,2002.csv,2002,0.6520819720980504,0.34791802790194964
2008,Dungeons & Dragons,33978694,15391970,18586724,2000.csv,2000,0.45298886413939277,0.5470111358606072
2009,The Fighting Temptations,33972062,30250745,3721317,2003.csv,2003,0.8904594899185101,0.1095405100814899
2010,The Witness,33963557,418063,33545494,2015.csv,2015,0.012309164202088727,0.9876908357979113
2011,Doraemon the Movie: Nobita's New Dinosaur,33942341,0,33942341,2020.csv,2020,0.0,1.0
2012,Skyfall 2021 Re-release,33910282,0,33910282,2022.csv,2022,0.0,1.0
2013,Alibi.com 2,33886910,0,33886910,2023.csv,2023,0.0,1.0
2014,Hotel Rwanda,33882243,23530892,10351351,2004.csv,2004,0.6944903854210597,0.3055096145789404
2015,The Good Liar,33856058,17156058,16700000,2019.csv,2019,0.5067352495674482,0.49326475043255186
2016,Hunt,33821338,25994,33795344,2022.csv,2022,0.0007685680560597573,0.9992314319439403
2017,Don't Go Breaking My Heart 2,33801759,0,33801759,2014.csv,2014,0.0,1.0
2018,Jay and Silent Bob Strike Back,33788161,30085147,3703014,2001.csv,2001,0.890404985343831,0.10959501465616907
2019,The Art of Racing in the Rain,33766787,26395642,7371145,2019.csv,2019,0.7817042823766442,0.21829571762335576
2020,I Want to Eat Your Pancreas,33748006,277019,33470987,2017.csv,2017,0.008208455338072419,0.9917915446619275
2021,Deliver Us from Evil,33718703,0,33718703,2020.csv,2020,0.0,1.0
2022,Nobody's Fool,33705333,31713110,1992223,2018.csv,2018,0.9408929441521909,0.05910705584780901
2023,And Your Mother Too,33616692,13839658,19777034,2001.csv,2001,0.411690061592021,0.588309938407979
2024,Because of Winn-Dixie,33589427,32647042,942385,2005.csv,2005,0.9719439989256143,0.0280560010743857
2025,Friday After Next,33526835,33253609,273226,2002.csv,2002,0.9918505280919001,0.008149471908099885
2026,Red Planet,33463969,17480890,15983079,2000.csv,2000,0.5223794583362182,0.4776205416637817
2027,Get on Up,33448971,30703100,2745871,2014.csv,2014,0.9179086555457865,0.08209134445421355
2028,Wonder Boys,33426588,19393557,14033031,2000.csv,2000,0.5801835652505125,0.41981643474948743
2029,Pokémon: Jirachi - Wish Maker,33393751,0,33393751,2003.csv,2003,0.0,1.0
2030,Girls,33325338,0,33325338,2014.csv,2014,0.0,1.0
2031,The Cave,33296457,15007991,18288466,2005.csv,2005,0.450738377359489,0.5492616226405109
2032,Marathon,33284089,0,33284089,2005.csv,2005,0.0,1.0
2033,Licorice Pizza,33273940,17318007,15955933,2021.csv,2021,0.5204675791324983,0.4795324208675017
2034,Perfect Strangers,33262366,1014507,32247859,2017.csv,2017,0.03050014541960124,0.9694998545803988
2035,Confessions of a Teenage Drama Queen,33251890,29331068,3920822,2004.csv,2004,0.8820872437626853,0.11791275623731463
2036,The Boy and the Heron,33248189,0,33248189,2023.csv,2023,0.0,1.0
2037,Brightburn,33224654,17300439,15924215,2019.csv,2019,0.5207108853563983,0.4792891146436017
2038,Project Almanac,33213241,22348241,10865000,2015.csv,2015,0.6728714310054836,0.32712856899451637
2039,Bharat,33185983,2971549,30214434,2019.csv,2019,0.08954229259986062,0.9104577074001394
2040,Baaghi 2,33139063,1319579,31819484,2018.csv,2018,0.039819442088631175,0.9601805579113688
2041,The Crocodile Hunter: Collision Course,33082548,28442574,4639974,2002.csv,2002,0.8597455673607728,0.14025443263922718
2042,Girl with a Pearl Earring,33030115,11670971,21359144,2003.csv,2003,0.3533433353168767,0.6466566646831232
2043,The Brice Man,33026616,0,33026616,2005.csv,2005,0.0,1.0
2044,Confessions of a Dangerous Mind,33013805,16007718,17006087,2002.csv,2002,0.4848795223695057,0.5151204776304943
2045,Inside Llewyn Davis,32935319,13235319,19700000,2013.csv,2013,0.40185792644060925,0.5981420735593908
2046,Sleepless,32917353,20783704,12133649,2017.csv,2017,0.6313905009312262,0.3686094990687738
2047,Respect,32882823,24278399,8604424,2021.csv,2021,0.7383307388176495,0.26166926118235045
2048,Serial Teachers,32849727,0,32849727,2013.csv,2013,0.0,1.0
2049,Tad the Lost Explorer and the Emerald Tablet,32849430,67599,32781831,2022.csv,2022,0.002057843926058991,0.997942156073941
2050,Hindi Medium,32841493,0,32841493,2017.csv,2017,0.0,1.0
2051,The Crossing,32806475,0,32806475,2014.csv,2014,0.0,1.0
2052,Fly Me to the Saitama,32802347,0,32802347,2019.csv,2019,0.0,1.0
2053,Adaptation.,32801173,22498520,10302653,2002.csv,2002,0.6859059583021619,0.31409404169783806
2054,Old Boys: The Way of the Dragon,32800000,0,32800000,2014.csv,2014,0.0,1.0
2055,Big Red Envelope,32800000,0,32800000,2021.csv,2021,0.0,1.0
2056,Steel Rain,32783733,0,32783733,2017.csv,2017,0.0,1.0
2057,Mud,32613173,21590086,11023087,2013.csv,2013,0.6620050738393348,0.3379949261606652
2058,BTS Permission to Dance on Stage - Seoul: Live Viewing,32600000,6840000,25760000,2022.csv,2022,0.2098159509202454,0.7901840490797546
2059,Cry Wolf,32586408,10047674,22538734,2005.csv,2005,0.30833941562383926,0.6916605843761607
2060,The Musketeer,32533802,27073640,5460162,2001.csv,2001,0.832169569360507,0.16783043063949304
2061,The Hurricane Heist,32517248,6115825,26401423,2018.csv,2018,0.18807941557661953,0.8119205844233804
2062,Midsummer's Equation,32514549,0,32514549,2013.csv,2013,0.0,1.0
2063,UglyDolls,32450241,20150241,12300000,2019.csv,2019,0.6209581309426947,0.3790418690573053
2064,The House That Never Dies II,32433588,0,32433588,2017.csv,2017,0.0,1.0
2065,Night Watch,32396890,0,32396890,2004.csv,2004,0.0,1.0
2066,Stuber,32390945,22370452,10020493,2019.csv,2019,0.6906390659488323,0.3093609340511677
2067,Hit Me Anyone One More Time!,32333512,0,32333512,2019.csv,2019,0.0,1.0
2068,Kevin Hart: Let Me Explain,32318051,32244051,74000,2013.csv,2013,0.997710257960791,0.002289742039208986
2069,Pokémon,32293377,0,32293377,2013.csv,2013,0.0,1.0
2070,Masquerade Night,32287400,0,32287400,2021.csv,2021,0.0,1.0
2071,Hart's War,32287044,19077641,13209403,2002.csv,2002,0.5908760492289106,0.4091239507710895
2072,Somewhere Winter,32218990,0,32218990,2019.csv,2019,0.0,1.0
2073,Once Upon a Time in Hong Kong,32218874,0,32218874,2021.csv,2021,0.0,1.0
2074,Home Sweet Home,32178677,0,32178677,2021.csv,2021,0.0,1.0
2075,Reindeer Games,32168970,23368995,8799975,2000.csv,2000,0.7264452358903627,0.2735547641096373
2076,The After-Dinner Mysteries,32160741,0,32160741,2013.csv,2013,0.0,1.0
2077,The Kid Who Would Be King,32140970,16790790,15350180,2019.csv,2019,0.5224108046521309,0.4775891953478691
2078,Shin Ultraman,32125023,601490,31523533,2022.csv,2022,0.01872341071942579,0.9812765892805743
2079,The Suspect: Muroi Shinji,32104229,0,32104229,2005.csv,2005,0.0,1.0
2080,Two Tigers,32001580,0,32001580,2019.csv,2019,0.0,1.0
2081,Os Dez Mandamentos - O Filme,31998251,0,31998251,2016.csv,2016,0.0,1.0
2082,Dilwale,31994323,4871263,27123060,2015.csv,2015,0.15225397955756087,0.8477460204424391
2083,Suffragette,31972096,4702420,27269676,2015.csv,2015,0.1470788777814254,0.8529211222185746
2084,All About Me,31920159,0,31920159,2018.csv,2018,0.0,1.0
2085,Bounty Hunters,31918573,0,31918573,2016.csv,2016,0.0,1.0
2086,Bad Times at the El Royale,31882724,17839115,14043609,2018.csv,2018,0.5595229253309724,0.44047707466902764
2087,Tinker Bell and the Legend of the NeverBeast,31836701,0,31836701,2014.csv,2014,0.0,1.0
2088,Marrying the Mafia 2: Enemy-in-Law,31835989,0,31835989,2005.csv,2005,0.0,1.0
2089,Self/less,31807156,12279691,19527465,2015.csv,2015,0.38606692783221486,0.6139330721677851
2090,Blood Work,31794718,26235081,5559637,2002.csv,2002,0.825139603376888,0.17486039662311206
2091,Welcome to Dongmakgol,31787130,0,31787130,2005.csv,2005,0.0,1.0
2092,Underdogs,31775719,0,31775719,2013.csv,2013,0.0,1.0
2093,Spring Breakers,31724284,14124284,17600000,2013.csv,2013,0.44521994570468476,0.5547800542953152
2094,Beautiful Boy,31711319,7649973,24061346,2018.csv,2018,0.24123793147803155,0.7587620685219685
2095,Suddenly Paradise,31679869,0,31679869,2003.csv,2003,0.0,1.0
2096,Hunter Killer,31672678,15767460,15905218,2018.csv,2018,0.49782528651350544,0.5021747134864946
2097,Rent,31670620,29077547,2593073,2005.csv,2005,0.918123705819463,0.08187629418053705
2098,New World,31670607,457806,31212801,2013.csv,2013,0.014455232891494628,0.9855447671085054
2099,Ae Dil Hai Mushkil,31668920,4264983,27403937,2016.csv,2016,0.1346740905594507,0.8653259094405493
2100,Anna,31626978,7743794,23883184,2019.csv,2019,0.2448477372703772,0.7551522627296228
2101,Super Troopers 2,31626386,30617396,1008990,2018.csv,2018,0.9680965760678442,0.03190342393215589
2102,Double Take,31603059,29831583,1771476,2001.csv,2001,0.9439460591457302,0.05605394085426983
2103,The Four 3,31521335,0,31521335,2014.csv,2014,0.0,1.0
2104,The New World 2005 Re-release,31510855,12712093,18798762,2005.csv,2005,0.4034194883001429,0.596580511699857
2105,Harry Potter and the Sorcerer's Stone 2020 Re-release,31501815,0,31501815,2020.csv,2020,0.0,1.0
2106,Wild Tales,31478893,3106530,28372363,2014.csv,2014,0.0986861259701858,0.9013138740298142
2107,Lost Souls,31355910,16815253,14540657,2000.csv,2000,0.5362706105483783,0.46372938945162173
2108,Assassination Classroom: The Graduation,31352921,0,31352921,2016.csv,2016,0.0,1.0
2109,Johnson Family Vacation,31326183,31203964,122219,2004.csv,2004,0.9960985032871703,0.003901496712829648
2110,101 Proposals,31283838,0,31283838,2013.csv,2013,0.0,1.0
2111,How High,31283740,31178740,105000,2001.csv,2001,0.9966436238122424,0.003356376187757602
2112,Tazza: The Hidden Card,31278476,251555,31026921,2014.csv,2014,0.008042431479078457,0.9919575685209215
2113,Perfect Strangers,31254929,0,31254929,2016.csv,2016,0.0,1.0
2114,Amsterdam,31245810,14947969,16297841,2022.csv,2022,0.47839915175826775,0.5216008482417323
2115,Saving Mr. Wu,31222161,92696,31129465,2015.csv,2015,0.0029689168536412326,0.9970310831463588
2116,Honest Thief,31220247,14163574,17056673,2020.csv,2020,0.4536663018713465,0.5463336981286535
2117,The Invisible Guest,31191910,0,31191910,2017.csv,2017,0.0,1.0
2118,My Dear Liar,31177968,90545,31087423,2019.csv,2019,0.0029041340987969455,0.997095865901203
2119,The Blind Swordsman: Zatoichi,31167430,0,31167430,2003.csv,2003,0.0,1.0
2120,The New Guy,31167388,29760152,1407236,2002.csv,2002,0.9548490877708457,0.0451509122291544
2121,The Three Musketeers: D'Artagnan,31165459,0,31165459,2023.csv,2023,0.0,1.0
2122,Mrs. Brown's Boys D'Movie,31116264,0,31116264,2014.csv,2014,0.0,1.0
2123,Train Man,31090100,0,31090100,2005.csv,2005,0.0,1.0
2124,The Wild Goose Lake,31064835,12573,31052262,2019.csv,2019,0.0004047341632427792,0.9995952658367572
2125,The Strangers: Prey at Night,31039126,24586708,6452418,2018.csv,2018,0.7921198554366512,0.20788014456334886
2126,Beauty and the Beast 2000 IMAX Release,31033346,25487190,5546156,2001.csv,2001,0.8212839827197492,0.17871601728025074
2127,This Is Not What I Expected,30996615,337670,30658945,2017.csv,2017,0.010893770174581966,0.9891062298254181
2128,Joe Dirt,30987695,27087695,3900000,2001.csv,2001,0.8741435915126956,0.1258564084873044
2129,Mrs. Harris Goes to Paris,30943379,10433915,20509464,2022.csv,2022,0.33719378223044094,0.6628062177695591
2130,Rise of the Legend,30932534,0,30932534,2014.csv,2014,0.0,1.0
2131,Billy Lynn's Long Halftime Walk,30930984,1738477,29192507,2016.csv,2016,0.05620503376161586,0.9437949662383841
2132,The Promise,30925693,669625,30256068,2005.csv,2005,0.021652707992671338,0.9783472920073286
2133,Hearts in Atlantis,30919415,24185781,6733634,2001.csv,2001,0.7822198770578292,0.2177801229421708
2134,Pandora,30896701,0,30896701,2016.csv,2016,0.0,1.0
2135,Gintama 2: Rules are Made to be Broken,30896653,0,30896653,2018.csv,2018,0.0,1.0
2136,The Little Things,30842746,15342746,15500000,2021.csv,2021,0.4974507133703335,0.5025492866296665
2137,The Unholy,30832137,15532137,15300000,2021.csv,2021,0.5037645298475418,0.4962354701524581
2138,Attack on Titan Part 1,30810658,449523,30361135,2015.csv,2015,0.014589853939503662,0.9854101460604964
2139,Winter's Tale,30800231,12600231,18200000,2014.csv,2014,0.40909534087585253,0.5909046591241475
2140,Monsoon Wedding,30787356,13885966,16901390,2001.csv,2001,0.45102820781362324,0.5489717921863768
2141,Wolf Creek,30762648,16188180,14574468,2005.csv,2005,0.5262284313105946,0.4737715686894054
2142,Norm of the North,30734502,17062499,13672003,2016.csv,2016,0.5551578157993254,0.44484218420067456
2143,A Man Called Ove,30692889,3479315,27213574,2015.csv,2015,0.11335899334858963,0.8866410066514103
2144,A Wedding Invitation,30665036,14350,30650686,2013.csv,2013,0.0004679596658552757,0.9995320403341448
2145,When the Bough Breaks,30658387,29747603,910784,2016.csv,2016,0.9702925010373181,0.02970749896268189
2146,City of God,30641770,7564459,23077311,2002.csv,2002,0.2468675601964247,0.7531324398035754
2147,The Last Warrior,30618274,0,30618274,2017.csv,2017,0.0,1.0
2148,Cabin Fever,30553394,21158188,9395206,2003.csv,2003,0.6924987777135332,0.30750122228646676
2149,The Last Duel,30552111,10853945,19698166,2021.csv,2021,0.35526006697213164,0.6447399330278684
2150,Two for the Money,30526509,22991379,7535130,2005.csv,2005,0.7531610968027821,0.24683890319721788
2151,Like a Boss,30399490,22169514,8229976,2020.csv,2020,0.7292725634541896,0.2707274365458105
2152,The Girl Next Door,30381722,14589444,15792278,2004.csv,2004,0.4802046440948936,0.5197953559051064
2153,S Storm,30381402,0,30381402,2016.csv,2016,0.0,1.0
2154,The Way of the Bug,30355804,0,30355804,2018.csv,2018,0.0,1.0
2155,Nocturnal Animals,30311857,10663357,19648500,2016.csv,2016,0.3517883117487655,0.6482116882512345
2156,A Silent Voice: The Movie,30277098,310407,29966691,2016.csv,2016,0.0102522044880259,0.9897477955119741
2157,Far from the Madding Crowd,30229977,12236500,17993477,2015.csv,2015,0.40478032781831097,0.595219672181689
2158,Tokyo MER,30226383,0,30226383,2023.csv,2023,0.0,1.0
2159,When the Game Stands Tall,30138754,30127963,10791,2014.csv,2014,0.9996419560012335,0.0003580439987665051
2160,Godsend,30120671,14379751,15740920,2004.csv,2004,0.47740473643498843,0.5225952635650115
2161,Clergy,30114115,0,30114115,2018.csv,2018,0.0,1.0
2162,Shaun of the Dead,30076102,13542874,16533228,2004.csv,2004,0.45028687560642,0.54971312439358
2163,Laws of Attraction,30031874,17871255,12160619,2003.csv,2003,0.5950762513188488,0.4049237486811512
2164,Solaris,30002758,14973382,15029376,2002.csv,2002,0.49906685245403104,0.500933147545969
2165,My Hero Academia: Heroes Rising,29971229,13304000,16667229,2019.csv,2019,0.4438923742499849,0.5561076257500152
2166,Reset 2017 Re-release,29949252,108970,29840282,2017.csv,2017,0.0036384881999724067,0.9963615118000276
2167,Small Time Crooks,29934477,17266359,12668118,2000.csv,2000,0.5768051000189514,0.4231948999810486
2168,Keeping Up with the Joneses,29918745,14904426,15014319,2016.csv,2016,0.4981634757741342,0.5018365242258658
2169,Escape from Mogadishu,29902716,346271,29556445,2021.csv,2021,0.01157991802483761,0.9884200819751624
2170,The Four Feathers,29882645,18306166,11576479,2002.csv,2002,0.6126019299831056,0.3873980700168944
2171,The Bye Bye Man,29874280,22395806,7478474,2017.csv,2017,0.7496684773658143,0.2503315226341857
2172,Vikram,29837637,1770000,28067637,2022.csv,2022,0.05932105146262085,0.9406789485373791
2173,Draft Day,29824199,28842237,981962,2014.csv,2014,0.9670749916871195,0.03292500831288042
2174,The Disaster Artist,29820616,21120616,8700000,2017.csv,2017,0.7082555236283516,0.2917444763716484
2175,Ice,29806210,0,29806210,2018.csv,2018,0.0,1.0
2176,Jackie,29777777,13960394,15817383,2016.csv,2016,0.46881921373781527,0.5311807862621847
2177,Battlefield Earth,29725663,21471685,8253978,2000.csv,2000,0.7223282118215496,0.2776717881784504
2178,The Swindlers,29721916,241916,29480000,2017.csv,2017,0.008139313764294335,0.9918606862357057
2179,Angel Eyes,29715606,24174218,5541388,2001.csv,2001,0.8135192666102787,0.1864807333897212
2180,Masterminds,29674699,17368022,12306677,2016.csv,2016,0.5852804774868988,0.4147195225131011
2181,Cursed,29621722,19297522,10324200,2005.csv,2005,0.6514652321698245,0.34853476783017545
2182,The Pledge,29419291,19733089,9686202,2001.csv,2001,0.670753384233495,0.32924661576650505
2183,City by the Sea,29414087,22449000,6965087,2002.csv,2002,0.7632057388012757,0.23679426119872427
2184,Luther,29413900,5791328,23622572,2003.csv,2003,0.19689085772372925,0.8031091422762707
2185,Free Solo,29390279,17541090,11849189,2018.csv,2018,0.5968330549022689,0.4031669450977311
2186,Bugs!,29388999,19063544,10325455,2003.csv,2003,0.6486625828936875,0.35133741710631244
2187,Baby Boy,29381649,28734552,647097,2001.csv,2001,0.977976151032231,0.022023848967768964
2188,Alibi.com,29370592,0,29370592,2017.csv,2017,0.0,1.0
2189,Nurse Betty,29360400,25170054,4190346,2000.csv,2000,0.8572789880246863,0.1427210119753137
2190,Mr. Holmes,29355203,17737646,11617557,2015.csv,2015,0.6042419805443008,0.3957580194556992
2191,Sword Art Online the Movie: Ordinal Scale,29322339,1522976,27799363,2017.csv,2017,0.05193910349375607,0.9480608965062439
2192,Christmas on the Nile,29320869,0,29320869,2002.csv,2002,0.0,1.0
2193,Silent Witness,29315945,0,29315945,2013.csv,2013,0.0,1.0
2194,The Witches,29303571,203571,29100000,2020.csv,2020,0.006946969022990406,0.9930530309770096
2195,BTS: Yet to Come in Cinemas,29291883,8093270,21198613,2023.csv,2023,0.276297361968843,0.723702638031157
2196,Big Eyes,29253166,14482031,14771135,2014.csv,2014,0.495058586137309,0.504941413862691
2197,Fall In Love At First Kiss,29206238,0,29206238,2019.csv,2019,0.0,1.0
2198,Dark Figure of Crime,29176133,0,29176133,2018.csv,2018,0.0,1.0
2199,Flight Crew,29171110,0,29171110,2016.csv,2016,0.0,1.0
2200,Viking,29161298,0,29161298,2016.csv,2016,0.0,1.0
2201,Yu-Gi-Oh!: The Movie - Pyramid of Light,29144802,19765868,9378934,2004.csv,2004,0.6781953090640314,0.32180469093596864
2202,Special ID,29139936,12666,29127270,2013.csv,2013,0.0004346612154535961,0.9995653387845465
2203,Tár,29126717,6773650,22353067,2022.csv,2022,0.23255796387900496,0.767442036120995
2204,Cold Creek Manor,29119434,21386011,7733423,2003.csv,2003,0.7344239932685505,0.26557600673144954
2205,The Unbearable Weight of Massive Talent,29116320,20300157,8816163,2022.csv,2022,0.6972088849140275,0.3027911150859724
2206,The Fatal Encounter,29060186,0,29060186,2014.csv,2014,0.0,1.0
2207,Pad Man,29045020,1670192,27374828,2018.csv,2018,0.057503558269197265,0.9424964417308027
2208,Far from Heaven,29027914,15901849,13126065,2002.csv,2002,0.5478123229936537,0.4521876770063464
2209,Recep Ivedik 5,28952258,0,28952258,2017.csv,2017,0.0,1.0
2210,Family Honor,28903789,0,28903789,2002.csv,2002,0.0,1.0
2211,M.S. Dhoni: The Untold Story,28903047,1801550,27101497,2016.csv,2016,0.06233079854867897,0.937669201451321
2212,Agent Cody Banks 2: Destination London,28818995,23630159,5188836,2004.csv,2004,0.8199508345103638,0.18004916548963626
2213,Kokowääh 2,28811936,0,28811936,2013.csv,2013,0.0,1.0
2214,Boiler Room,28780255,16970581,11809674,2000.csv,2000,0.5896605502626714,0.4103394497373286
2215,Mirai,28756961,812794,27944167,2018.csv,2018,0.028264252262260953,0.9717357477377391
2216,Judwaa 2,28733523,1431255,27302268,2017.csv,2017,0.04981133013170713,0.9501886698682929
2217,Bath Buddy,28700000,0,28700000,2020.csv,2020,0.0,1.0
2218,Master,28692230,0,28692230,2021.csv,2021,0.0,1.0
2219,The Suspect,28674130,218693,28455437,2013.csv,2013,0.007626839942484741,0.9923731600575153
2220,Wrong Turn,28650575,15418790,13231785,2003.csv,2003,0.5381668605254868,0.46183313947451315
2221,The Fortress,28645448,252895,28392553,2017.csv,2017,0.008828453302598025,0.9911715466974019
2222,Love & Mercy,28641776,12551031,16090745,2015.csv,2015,0.43820714888629814,0.5617928511137019
2223,Maya the Bee Movie,28638603,0,28638603,2014.csv,2014,0.0,1.0
2224,The Four 2,28599970,0,28599970,2013.csv,2013,0.0,1.0
2225,Pokémon the Movie: Diancie and the Cocoon of Destruction,28595105,0,28595105,2014.csv,2014,0.0,1.0
2226,Scoob!,28588425,2188425,26400000,2020.csv,2020,0.07654933771272814,0.9234506622872719
2227,Flying Colors,28525563,0,28525563,2015.csv,2015,0.0,1.0
2228,Heist,28510652,23510841,4999811,2001.csv,2001,0.8246335790566979,0.17536642094330218
2229,Ala Vaikunthapurramuloo,28477890,0,28477890,2020.csv,2020,0.0,1.0
2230,The Last Warrior: Root of Evil,28357398,0,28357398,2021.csv,2021,0.0,1.0
2231,The Kiyosu Conference,28338665,0,28338665,2013.csv,2013,0.0,1.0
2232,I Give It a Year,28328531,34657,28293874,2013.csv,2013,0.0012233955936507969,0.9987766044063492
2233,Brown Sugar,28316451,27363891,952560,2002.csv,2002,0.9663601911129329,0.0336398088870671
2234,Gully Boy,28299498,5566534,22732964,2019.csv,2019,0.19670080366796613,0.8032991963320338
2235,Thunderbirds,28283637,6880917,21402720,2004.csv,2004,0.24328260895159984,0.7567173910484002
2236,Fan,28240000,2300000,25940000,2016.csv,2016,0.08144475920679886,0.9185552407932012
2237,The Upside of Anger,28237488,18761993,9475495,2005.csv,2005,0.664435625435237,0.33556437456476296
2238,The Spanish Apartment,28193749,1067438,27126311,2002.csv,2002,0.03786080382569909,0.9621391961743009
2239,"Yôkai Watch: the Movie: The Flying Whale and the Grand Adventure of the Double Worlds, Meow!",28110245,0,28110245,2016.csv,2016,0.0,1.0
2240,Triumph in the Skies,28085162,0,28085162,2015.csv,2015,0.0,1.0
2241,Welcome to Germany,28036021,0,28036021,2016.csv,2016,0.0,1.0
2242,Pokemon 4Ever: Celebi - Voice of the Forest,28023563,1727447,26296116,2002.csv,2002,0.06164266121335107,0.938357338786649
2243,Book Club: The Next Chapter,28013296,17556340,10456956,2023.csv,2023,0.6267145429798764,0.3732854570201236
2244,The Tailor of Panama,28008462,13729742,14278720,2001.csv,2001,0.4901997831940933,0.5098002168059067
2245,Mandela: Long Walk to Freedom,27985788,8323085,19662703,2013.csv,2013,0.29740398948208996,0.70259601051791
2246,The Brothers Grimsby,27979040,6874837,21104203,2016.csv,2016,0.24571382720779555,0.7542861727922044
2247,What Happened to Monday,27975429,0,27975429,2017.csv,2017,0.0,1.0
2248,The 33,27972023,12227722,15744301,2015.csv,2015,0.4371411392018375,0.5628588607981625
2249,The Little Vampire,27965865,13572400,14393465,2000.csv,2000,0.4853202287860576,0.5146797712139424
2250,The Brothers,27958191,27457409,500782,2001.csv,2001,0.9820881830301539,0.017911816969846152
2251,The Divine Move,27926871,136707,27790164,2014.csv,2014,0.004895177837860891,0.9951048221621391
2252,Serial (Bad) Weddings 3,27894646,0,27894646,2022.csv,2022,0.0,1.0
2253,Monster Family,27890108,127259,27762849,2017.csv,2017,0.004562872255639885,0.9954371277443601
2254,Mrs. Henderson Presents,27876417,11036366,16840051,2005.csv,2005,0.3959033185649361,0.6040966814350639
2255,The Beguiled,27869129,10709995,17159134,2017.csv,2017,0.3842960072415611,0.6157039927584389
2256,When Larry Meets Mary,27863090,0,27863090,2016.csv,2016,0.0,1.0
2257,Dark Skies,27858103,17418667,10439436,2013.csv,2013,0.6252639312877837,0.3747360687122163
2258,The 355,27827745,14570455,13257290,2022.csv,2022,0.5235945276916977,0.4764054723083024
2259,Love & Basketball,27728118,27459615,268503,2000.csv,2000,0.9903165804473278,0.009683419552672129
2260,Ruby & Quentin,27720972,312824,27408148,2003.csv,2003,0.011284741386413145,0.9887152586135869
2261,Kim Ji-young: Born 1982,27696393,0,27696393,2019.csv,2019,0.0,1.0
2262,Default,27694043,203775,27490268,2018.csv,2018,0.007358080580722721,0.9926419194192773
2263,Dirty Dancing: Havana Nights,27685016,14161590,13523426,2004.csv,2004,0.5115254403320554,0.48847455966794456
2264,Nebraska,27682872,17654912,10027960,2013.csv,2013,0.6377557935462765,0.36224420645372346
2265,The Quiet American,27674124,12988801,14685323,2002.csv,2002,0.46934822580111296,0.530651774198887
2266,Bride Wars,27670000,0,27670000,2015.csv,2015,0.0,1.0
2267,Ice Princess,27645491,24402491,3243000,2005.csv,2005,0.882693347714461,0.11730665228553908
2268,The Last Castle,27642707,18244060,9398647,2001.csv,2001,0.659995419406645,0.34000458059335503
2269,Goal! The Dream Begins,27610873,4283255,23327618,2005.csv,2005,0.15512928548112187,0.8448707145188781
2270,One Cut of the Dead,27590180,52406,27537774,2018.csv,2018,0.0018994439325876091,0.9981005560674124
2271,Nicholas on Holiday,27567832,0,27567832,2014.csv,2014,0.0,1.0
2272,Cirque du Soleil: Journey of Man,27538359,15627434,11910925,2000.csv,2000,0.5674787666178657,0.43252123338213433
2273,Grace of Monaco,27515247,0,27515247,2014.csv,2014,0.0,1.0
2274,The Happytime Murders,27506452,20706452,6800000,2018.csv,2018,0.7527852737968532,0.2472147262031468
2275,The Incredible Burt Wonderstone,27437881,22537881,4900000,2013.csv,2013,0.8214147805364416,0.17858521946355843
2276,Yesterday Once More,27413790,0,27413790,2016.csv,2016,0.0,1.0
2277,Left Behind,27405896,14019924,13385972,2014.csv,2014,0.5115659783573578,0.48843402164264216
2278,Irrational Man,27391084,4030360,23360724,2015.csv,2015,0.14714131065422603,0.852858689345774
2279,Ella Enchanted,27388767,22918387,4470380,2004.csv,2004,0.8367805312301938,0.16321946876980625
2280,Detective K: Secret of the Lost Island,27387870,185367,27202503,2015.csv,2015,0.006768215271943382,0.9932317847280566
2281,Gorko!,27369902,0,27369902,2013.csv,2013,0.0,1.0
2282,Midnight Sun,27365467,9561064,17804403,2018.csv,2018,0.34938428056060583,0.6506157194393942
2283,Pokémon: Mewtwo Strikes Back - Evolution,27347118,0,27347118,2019.csv,2019,0.0,1.0
2284,To the Fore,27267799,0,27267799,2015.csv,2015,0.0,1.0
2285,American Ultra,27262374,14440985,12821389,2015.csv,2015,0.5297038695162791,0.4702961304837209
2286,VIP Policeman,27222681,0,27222681,2018.csv,2018,0.0,1.0
2287,Khumba,27187375,1029,27186346,2013.csv,2013,3.7848449877930475e-05,0.999962151550122
2288,The Protector,27165581,12044087,15121494,2005.csv,2005,0.44335834378068334,0.5566416562193166
2289,Joy of Fatherhood,27088817,0,27088817,2014.csv,2014,0.0,1.0
2290,My Neighbor Totoro 2018 Re-release,27083857,1144649,25939208,2018.csv,2018,0.042263145902741994,0.9577368540972581
2291,The Last Warrior: A Messenger of Darkness,27052365,0,27052365,2021.csv,2021,0.0,1.0
2292,The Crime of Padre Amaro,26996738,5717044,21279694,2002.csv,2002,0.21176795507664667,0.7882320449233533
2293,Almost a Comedy,26990962,0,26990962,2019.csv,2019,0.0,1.0
2294,Total Dhamaal,26911995,2167632,24744363,2019.csv,2019,0.08054519926895051,0.9194548007310495
2295,You're Next,26895481,18494006,8401475,2013.csv,2013,0.6876250326216512,0.3123749673783488
2296,The In-Laws,26891849,20453431,6438418,2003.csv,2003,0.7605810593388354,0.23941894066116465
2297,Mr. Go,26835201,0,26835201,2013.csv,2013,0.0,1.0
2298,CHIPS,26800152,18600152,8200000,2017.csv,2017,0.6940315860895118,0.3059684139104883
2299,The Faces of My Gene,26796279,0,26796279,2018.csv,2018,0.0,1.0
2300,The Night Owl,26719364,0,26719364,2022.csv,2022,0.0,1.0
2301,Doogal,26711924,7438000,19273924,2005.csv,2005,0.27845242446781443,0.7215475755321855
2302,Doraemon: Nobita in the Wan-Nyan Spacetime Odyssey,26663978,0,26663978,2004.csv,2004,0.0,1.0
2303,A Cure for Wellness,26620002,8106986,18513016,2017.csv,2017,0.3045449057441844,0.6954550942558156
2304,Missing Link,26565710,16649539,9916171,2019.csv,2019,0.626730435587831,0.3732695644121689
2305,American Underdog,26514814,26514814,0,2021.csv,2021,1.0,0.0
2306,Chaos Walking,26508132,13287908,13220224,2021.csv,2021,0.501276664836285,0.49872333516371503
2307,No Manches Frida 2,26493648,9270920,17222728,2019.csv,2019,0.3499299152762957,0.6500700847237043
2308,A Hard Day,26488847,19004,26469843,2014.csv,2014,0.0007174340204388662,0.9992825659795611
2309,The Break Up Man,26477012,0,26477012,2013.csv,2013,0.0,1.0
2310,The Way Way Back,26474920,21506546,4968374,2013.csv,2013,0.8123365811870253,0.18766341881297469
2311,We Are the Nobles,26433651,0,26433651,2013.csv,2013,0.0,1.0
2312,Emma.,26404660,10055355,16349305,2020.csv,2020,0.3808174390429568,0.6191825609570432
2313,Center Stage,26385941,17200925,9185016,2000.csv,2000,0.65189734942559,0.3481026505744101
2314,Only the Brave,26351322,18343983,8007339,2017.csv,2017,0.6961314123063731,0.3038685876936269
2315,Renfield,26348085,17152625,9195460,2023.csv,2023,0.6510008222608967,0.3489991777391032
2316,Saving Grace,26330482,12178602,14151880,2000.csv,2000,0.46252863886046597,0.537471361139534
2317,All About the Benjamins,26306533,25916319,390214,2002.csv,2002,0.9851666504286216,0.014833349571378334
2318,Twenty Two,26289378,46796,26242582,2017.csv,2017,0.0017800345067121785,0.9982199654932878
2319,Orange,26261536,0,26261536,2015.csv,2015,0.0,1.0
2320,Aloha,26250020,21067116,5182904,2015.csv,2015,0.8025561885286182,0.19744381147138174
2321,The Stolen Years,26249553,0,26249553,2013.csv,2013,0.0,1.0
2322,The Confidence Man JP,26228317,0,26228317,2019.csv,2019,0.0,1.0
2323,One Night Surprise,26220159,0,26220159,2013.csv,2013,0.0,1.0
2324,Triangle of Sadness,26200425,4608096,21592329,2022.csv,2022,0.17587867372380409,0.8241213262761959
2325,Typhoon,26179656,139059,26040597,2005.csv,2005,0.005311719909535863,0.9946882800904642
2326,The Whole Ten Yards,26170671,16328471,9842200,2004.csv,2004,0.6239225199842985,0.37607748001570157
2327,The Zookeeper's Wife,26152835,17571660,8581175,2017.csv,2017,0.6718835644395722,0.32811643556042774
2328,9th Company,26146165,0,26146165,2005.csv,2005,0.0,1.0
2329,The Bride of Badrinath,26134309,1993259,24141050,2017.csv,2017,0.0762698183449197,0.9237301816550803
2330,Badhaai Ho,26125610,0,26125610,2018.csv,2018,0.0,1.0
2331,Top Five,26117471,25317471,800000,2014.csv,2014,0.9693691628871723,0.030630837112827655
2332,Saving Silverman,26086706,19402030,6684676,2001.csv,2001,0.7437516258281134,0.2562483741718866
2333,Hichki,26055222,330279,25724943,2018.csv,2018,0.012676115367583512,0.9873238846324165
2334,Platinum Data,26052718,0,26052718,2013.csv,2013,0.0,1.0
2335,Iceman,26033917,7679,26026238,2014.csv,2014,0.0002949613767302093,0.9997050386232698
2336,The Courier,26001227,6613432,19387795,2021.csv,2021,0.25435076583116634,0.7456492341688337
2337,The Light Between Oceans,25975621,12545979,13429642,2016.csv,2016,0.48299053177592943,0.5170094682240706
2338,A Chinese Odyssey: Part 2 - Cinderella 2017 Re-release,25960664,0,25960664,2017.csv,2017,0.0,1.0
2339,Love Off the Cuff,25959989,0,25959989,2017.csv,2017,0.0,1.0
2340,The Confidence Man JP: The Movie,25958189,0,25958189,2019.csv,2019,0.0,1.0
2341,White Boy Rick,25957482,24011188,1946294,2018.csv,2018,0.925019922964793,0.07498007703520704
2342,Meet Miss Anxiety,25948636,0,25948636,2014.csv,2014,0.0,1.0
2343,"Paul, Apostle of Christ",25915966,17560475,8355491,2018.csv,2018,0.6775929170458087,0.32240708295419124
2344,Huevos: Little Rooster's Egg-cellent Adventure,25892561,9080818,16811743,2015.csv,2015,0.3507114649647827,0.6492885350352172
2345,Champions,25862631,0,25862631,2018.csv,2018,0.0,1.0
2346,Gekijouban SPEC: Kurôzu - Zen no hen,25860404,0,25860404,2013.csv,2013,0.0,1.0
2347,Rollerball,25852764,18990798,6861966,2002.csv,2002,0.7345751502624632,0.26542484973753677
2348,Boys and Girls,25850615,21799652,4050963,2000.csv,2000,0.8432933607188843,0.15670663928111575
2349,Dügün Dernek 2: Sünnet,25836668,0,25836668,2015.csv,2015,0.0,1.0
2350,The Alamo,25819961,22414961,3405000,2004.csv,2004,0.8681252849297487,0.13187471507025128
2351,Leap,25818882,83074,25735808,2020.csv,2020,0.00321756767004861,0.9967824323299513
2352,Unbeatable,25816154,0,25816154,2013.csv,2013,0.0,1.0
2353,"The Gangster, the Cop, the Devil",25775371,216494,25558877,2019.csv,2019,0.008399258346271718,0.9916007416537282
2354,Man on the Edge,25774679,0,25774679,2013.csv,2013,0.0,1.0
2355,A Beautiful Planet,25730120,15650615,10079505,2016.csv,2016,0.6082604744944835,0.3917395255055165
2356,Fireworks,25672406,525280,25147126,2017.csv,2017,0.020460879280266915,0.979539120719733
2357,Natale a Miami,25643184,0,25643184,2005.csv,2005,0.0,1.0
2358,Jonah: A VeggieTales Movie,25615231,25581229,34002,2002.csv,2002,0.9986725866341006,0.0013274133658993745
2359,Father Figures,25601244,17501244,8100000,2017.csv,2017,0.6836091246191005,0.31639087538089944
2360,"Love, Rosie",25574387,20431,25553956,2014.csv,2014,0.0007988852284123173,0.9992011147715877
2361,Mr. Donkey,25537759,356255,25181504,2016.csv,2016,0.013950127730471574,0.9860498722695284
2362,Look Who's Back,25513752,0,25513752,2015.csv,2015,0.0,1.0
2363,The Tiger and the Snow,25460023,10167,25449856,2005.csv,2005,0.00039933192519111236,0.9996006680748089
2364,Calendar Girls,25433615,0,25433615,2022.csv,2022,0.0,1.0
2365,Money,25403753,0,25403753,2017.csv,2017,0.0,1.0
2366,In America,25382911,15539656,9843255,2003.csv,2003,0.6122093718880391,0.38779062811196086
2367,Leap! 2017 Re-release,25376094,21858070,3518024,2017.csv,2017,0.8613646371265806,0.13863536287341938
2368,Keys To The Heart,25375866,75134,25300732,2018.csv,2018,0.0029608447648643795,0.9970391552351356
2369,Serial Teachers 2,25364150,0,25364150,2015.csv,2015,0.0,1.0
2370,A Haunted House 2,25358716,17329486,8029230,2014.csv,2014,0.6833739531607199,0.31662604683928003
2371,And So It Goes,25312387,15160801,10151586,2014.csv,2014,0.5989478985130877,0.40105210148691234
2372,Bodies at Rest,25293853,0,25293853,2019.csv,2019,0.0,1.0
2373,Enough Said,25288872,17550872,7738000,2013.csv,2013,0.6940156128751017,0.3059843871248983
2374,Corky Romano,25272752,23980304,1292448,2001.csv,2001,0.9488600212592597,0.05113997874074022
2375,Spencer,25246967,7086632,18160335,2021.csv,2021,0.2806924095080411,0.7193075904919589
2376,North Country,25211175,18337722,6873453,2005.csv,2005,0.7273648292870126,0.2726351707129874
2377,Born in China,25081168,13873211,11207957,2016.csv,2016,0.5531325734112542,0.4468674265887458
2378,Race,25070261,19206207,5864054,2016.csv,2016,0.7660952153629353,0.2339047846370646
2379,The Last Exorcism Part II,25051865,15179302,9872563,2013.csv,2013,0.6059150486400913,0.39408495135990873
2380,Call of Heroes,25040561,0,25040561,2016.csv,2016,0.0,1.0
2381,Free State of Jones,25035950,20810036,4225914,2016.csv,2016,0.8312061655339622,0.16879383446603785
2382,"Me, Myself and Mum",24991467,0,24991467,2013.csv,2013,0.0,1.0
2383,Whiskey Tango Foxtrot,24972139,23083334,1888805,2016.csv,2016,0.924363507667485,0.07563649233251504
2384,Booksmart,24959607,22680962,2278645,2019.csv,2019,0.9087066955821861,0.09129330441781396
2385,The Way Home,24952738,445367,24507371,2002.csv,2002,0.017848422084983218,0.9821515779150167
2386,April Snow,24873159,0,24873159,2005.csv,2005,0.0,1.0
2387,Gravity 2020 Re-release,24857244,0,24857244,2020.csv,2020,0.0,1.0
2388,Seed of Chucky,24829644,17083732,7745912,2004.csv,2004,0.6880377342502373,0.31196226574976266
2389,The Kashmir Files,24821898,1485000,23336898,2022.csv,2022,0.059826206682502686,0.9401737933174973
2390,Wild City,24817852,34866,24782986,2015.csv,2015,0.0014048758127818636,0.9985951241872182
2391,The Miracle of Bern,24816394,0,24816394,2003.csv,2003,0.0,1.0
2392,Talk to Me,24804842,22135092,2669750,2023.csv,2023,0.8923698042503153,0.10763019574968467
2393,Bride & Prejudice,24716440,6605592,18110848,2004.csv,2004,0.26725499303297723,0.7327450069670227
2394,Super 30,24701637,2269878,22431759,2019.csv,2019,0.09189180457959123,0.9081081954204088
2395,The Shipping News,24690441,11434216,13256225,2001.csv,2001,0.4631029474119154,0.5368970525880846
2396,Soulmate,24684439,0,24684439,2016.csv,2016,0.0,1.0
2397,Drug War,24676341,128195,24548146,2013.csv,2013,0.005195057079167451,0.9948049429208325
2398,Punch-Drunk Love,24665649,17844216,6821433,2002.csv,2002,0.7234440091156734,0.27655599088432664
2399,The Death of Stalin,24646055,8047856,16598199,2017.csv,2017,0.32653728963925466,0.6734627103607453
2400,The Snow Queen 3: Fire and Ice,24644317,0,24644317,2016.csv,2016,0.0,1.0
2401,Joe Somebody,24516772,22771646,1745126,2001.csv,2001,0.9288190957602412,0.07118090423975881
2402,Podium,24511116,0,24511116,2004.csv,2004,0.0,1.0
2403,God's Not Dead 2,24487848,20774575,3713273,2016.csv,2016,0.8483626245964937,0.15163737540350627
2404,Skyfire,24444590,1105,24443485,2019.csv,2019,4.5204276283627584e-05,0.9999547957237164
2405,The Tale of The Princess Kaguya,24434485,703232,23731253,2013.csv,2013,0.028780307831329368,0.9712196921686707
2406,The 8-Year Engagement,24425963,0,24425963,2017.csv,2017,0.0,1.0
2407,Stan & Ollie,24420923,5470235,18950688,2018.csv,2018,0.22399788083357866,0.7760021191664214
2408,Down to You,24419914,20069008,4350906,2000.csv,2000,0.8218295936668737,0.1781704063331263
2409,Hero,24392492,0,24392492,2022.csv,2022,0.0,1.0
2410,The Next Best Thing,24362772,14990582,9372190,2000.csv,2000,0.61530691170939,0.38469308829060994
2411,Detective Conan: Crossroad in the Ancient Capital,24342320,0,24342320,2003.csv,2003,0.0,1.0
2412,The Witch: Part 1 - The Subversion,24340302,0,24340302,2018.csv,2018,0.0,1.0
2413,The Great Beauty,24325911,2852400,21473511,2013.csv,2013,0.11725768461456593,0.8827423153854341
2414,Nowhere in Africa,24322180,6180200,18141980,2001.csv,2001,0.25409728897656375,0.7459027110234362
2415,Tanguy,24272365,0,24272365,2001.csv,2001,0.0,1.0
2416,Trance,24261569,2328743,21932826,2013.csv,2013,0.09598484747626998,0.90401515252373
2417,The Accidental Detective 2: In Action,24243825,179045,24064780,2018.csv,2018,0.0073851795250955655,0.9926148204749045
2418,Camping 3,24224579,0,24224579,2016.csv,2016,0.0,1.0
2419,Jolly LLB 2,24214186,1654254,22559932,2017.csv,2017,0.06831755566757437,0.9316824443324256
2420,The Railway Man,24174885,4438438,19736447,2013.csv,2013,0.18359706778336277,0.8164029322166372
2421,The Guru,24128852,3095506,21033346,2002.csv,2002,0.12829064557236292,0.8717093544276371
2422,The Founder,24121245,12786053,11335192,2016.csv,2016,0.5300743390318369,0.46992566096816313
2423,Out of Inferno,24109886,0,24109886,2013.csv,2013,0.0,1.0
2424,Start-Up,24106579,0,24106579,2019.csv,2019,0.0,1.0
2425,The Father,24095959,2122771,21973188,2020.csv,2020,0.088096555941185,0.911903444058815
2426,Bad Santa 2,24079268,17782178,6297090,2016.csv,2016,0.7384849904905747,0.2615150095094253
2427,Kung Fu Jungle,24070765,129784,23940981,2014.csv,2014,0.0053917688116684286,0.9946082311883315
2428,I Can Speak,24024444,63239,23961205,2017.csv,2017,0.0026322773588433514,0.9973677226411567
2429,Dark Water,24010000,0,24010000,2002.csv,2002,0.0,1.0
2430,Bring Happiness Home,23980000,0,23980000,2013.csv,2013,0.0,1.0
2431,I Love You in Every Language in the World,23941317,0,23941317,2005.csv,2005,0.0,1.0
2432,Harold & Kumar Go to White Castle,23936908,18250550,5686358,2004.csv,2004,0.7624439213285191,0.23755607867148087
2433,Killing for the Prosecution,23929620,0,23929620,2018.csv,2018,0.0,1.0
2434,25th Hour,23928503,13084595,10843908,2002.csv,2002,0.5468204592656716,0.4531795407343284
2435,Birth,23925492,5095038,18830454,2004.csv,2004,0.21295436683182942,0.7870456331681706
2436,Mortadelo & Filemon: The Big Adventure,23920411,0,23920411,2003.csv,2003,0.0,1.0
2437,Sex Is Zero,23915279,0,23915279,2002.csv,2002,0.0,1.0
2438,Life as a House,23903791,15667270,8236521,2001.csv,2001,0.6554303457556168,0.34456965424438324
2439,Spirits' Homecoming,23857217,125616,23731601,2016.csv,2016,0.0052653249538703525,0.9947346750461297
2440,Pinocchio,23841090,1831718,22009372,2019.csv,2019,0.07683029593026158,0.9231697040697384
2441,Silence,23834809,7100177,16734632,2016.csv,2016,0.2978910802264033,0.7021089197735967
2442,Lady Vengeance,23834149,211667,23622482,2005.csv,2005,0.00888082893163083,0.9911191710683692
2443,Eight Crazy Nights,23833131,23586598,246533,2002.csv,2002,0.9896558702253598,0.010344129774640184
2444,A Rainy Day in New York,23805899,0,23805899,2019.csv,2019,0.0,1.0
2445,Detective Conan: The Phantom of Baker Street,23786606,0,23786606,2002.csv,2002,0.0,1.0
2446,Interstellar 2020 Re-release,23771122,0,23771122,2020.csv,2020,0.0,1.0
2447,Dickie Roberts: Former Child Star,23769505,22738671,1030834,2003.csv,2003,0.9566320796331266,0.04336792036687344
2448,Pokémon the Movie: The Power of Us,23740788,789170,22951618,2018.csv,2018,0.0332411038757433,0.9667588961242567
2449,Russian Dolls,23727301,326095,23401206,2005.csv,2005,0.013743451056654105,0.9862565489433459
2450,In the Cut,23726793,4750602,18976191,2003.csv,2003,0.20022099067497237,0.7997790093250277
2451,Harry Potter and the Chamber of Secrets 2022 Re-release,23716329,0,23716329,2022.csv,2022,0.0,1.0
2452,The Peanut Butter Falcon,23712090,20457151,3254939,2019.csv,2019,0.862730826342174,0.13726917365782604
2453,The Last 10 Years,23683922,0,23683922,2022.csv,2022,0.0,1.0
2454,Little White Lies 2,23623665,0,23623665,2019.csv,2019,0.0,1.0
2455,The Glass House,23619609,18150259,5469350,2001.csv,2001,0.7684402819707981,0.23155971802920192
2456,Kevin Hart: What Now?,23591043,23591043,0,2016.csv,2016,1.0,0.0
2457,Hustle & Flow,23563727,22202809,1360918,2005.csv,2005,0.9422452144348812,0.057754785565118795
2458,No manches Frida,23540937,11528613,12012324,2016.csv,2016,0.48972617360133114,0.5102738263986688
2459,Biker Boyz,23510621,22076772,1433849,2003.csv,2003,0.9390127125948736,0.06098728740512639
2460,Wish Upon,23468586,14301505,9167081,2017.csv,2017,0.6093892917110558,0.39061070828894423
2461,Tomcats,23430766,13558739,9872027,2001.csv,2001,0.5786724599614029,0.4213275400385971
2462,Ossan's Love: Love or Dead,23422744,0,23422744,2019.csv,2019,0.0,1.0
2463,Only Cloud Knows,23414998,0,23414998,2019.csv,2019,0.0,1.0
2464,Kingdom Come,23396049,23249649,146400,2001.csv,2001,0.9937425331943868,0.006257466805613204
2465,Antwone Fisher,23367586,21078145,2289441,2002.csv,2002,0.9020249246113826,0.09797507538861738
2466,Detroit,23355100,16790139,6564961,2017.csv,2017,0.7189067484189748,0.2810932515810251
2467,Middle School: The Worst Years of My Life,23316139,20007149,3308990,2016.csv,2016,0.8580815631610362,0.14191843683896377
2468,Ali G Indahouse,23280529,0,23280529,2002.csv,2002,0.0,1.0
2469,Yomigaeri,23259542,0,23259542,2003.csv,2003,0.0,1.0
2470,Another Public Enemy,23248003,0,23248003,2005.csv,2005,0.0,1.0
2471,The Confidence Man JP: Episode of the Hero,23214581,0,23214581,2022.csv,2022,0.0,1.0
2472,Super Troopers,23182223,18492362,4689861,2002.csv,2002,0.7976958033748532,0.2023041966251468
2473,Triple 9,23177948,12639297,10538651,2016.csv,2016,0.5453156163781194,0.4546843836218806
2474,The Guernsey Literary and Potato Peel Pie Society,23148937,0,23148937,2018.csv,2018,0.0,1.0
2475,The Crimes That Bind,23144130,0,23144130,2018.csv,2018,0.0,1.0
2476,Rock Dog,23139802,9420546,13719256,2016.csv,2016,0.4071143737530684,0.5928856262469316
2477,New Happy Dad and Son 3: Adventure in Russia,23130469,0,23130469,2018.csv,2018,0.0,1.0
2478,Dark Waters,23108017,11136084,11971933,2019.csv,2019,0.48191430705629135,0.5180856929437087
2479,Parallel Mothers,23099920,2297501,20802419,2021.csv,2021,0.09945926219657904,0.9005407378034209
2480,The Marksman,23076711,15566093,7510618,2021.csv,2021,0.6745368956607378,0.32546310433926223
2481,The Farewell,23076657,17695781,5380876,2019.csv,2019,0.7668260181706562,0.23317398182934382
2482,The Witch: Part 2 - The Other One,23068596,143723,22924873,2022.csv,2022,0.006230244788196039,0.993769755211804
2483,The Choice,23064015,18730891,4333124,2016.csv,2016,0.8121262061267304,0.1878737938732697
2484,99.9 Criminal Lawyer: The Movie,23055069,0,23055069,2021.csv,2021,0.0,1.0
2485,"The Legend of Al, John and Jack",23039985,0,23039985,2002.csv,2002,0.0,1.0
2486,Confidence,23014206,12251640,10762566,2003.csv,2003,0.5323511921288964,0.46764880787110363
2487,Padmaavat,22991060,11846060,11145000,2018.csv,2018,0.5152463609768319,0.48475363902316815
2488,Last Night in Soho,22957625,10127625,12830000,2021.csv,2021,0.4411442821284867,0.5588557178715132
2489,Penny Pincher!,22955486,0,22955486,2016.csv,2016,0.0,1.0
2490,The Human Stain,22954068,5381908,17572160,2003.csv,2003,0.23446423527193525,0.7655357647280647
2491,Domino,22944502,10169202,12775300,2005.csv,2005,0.4432086606194373,0.5567913393805627
2492,The Knight of Shadows: Between Yin and Yang,22936257,0,22936257,2019.csv,2019,0.0,1.0
2493,Hot Road,22916313,0,22916313,2014.csv,2014,0.0,1.0
2494,Decision to Leave,22874861,2179864,20694997,2022.csv,2022,0.09529518015431875,0.9047048198456813
2495,Won't You Be My Neighbor?,22844741,22835787,8954,2018.csv,2018,0.9996080498351897,0.0003919501648103605
2496,Dr. T & the Women,22844291,13113041,9731250,2000.csv,2000,0.5740182962999377,0.42598170370006233
2497,Extraordinary Mission,22757764,54174,22703590,2017.csv,2017,0.0023804623336457836,0.9976195376663543
2498,Black and Blue,22741061,22055313,685748,2019.csv,2019,0.9698453823240701,0.030154617675929897
2499,Poupelle of Chimney Town,22715146,0,22715146,2020.csv,2020,0.0,1.0
2500,Fading Gigolo,22706304,3769873,18936431,2014.csv,2014,0.1660275930420028,0.8339724069579972
2501,Christmas in Love,22668087,0,22668087,2004.csv,2004,0.0,1.0
2502,The White Massai,22632255,0,22632255,2005.csv,2005,0.0,1.0
2503,Detective Conan: Magician of the Silver Sky,22618511,0,22618511,2004.csv,2004,0.0,1.0
2504,EuroTrip,22605153,17771387,4833766,2004.csv,2004,0.7861653048753973,0.2138346951246028
2505,The Day We Lit Up the Sky,22500000,0,22500000,2021.csv,2021,0.0,1.0
2506,Swimming Pool,22441497,10130108,12311389,2003.csv,2003,0.45140072429214506,0.5485992757078549
2507,Europe Raiders,22435156,0,22435156,2018.csv,2018,0.0,1.0
2508,Two Can Play That Game,22391450,22235901,155549,2001.csv,2001,0.9930531966442548,0.006946803355745161
2509,Late Night,22386555,15499454,6887101,2019.csv,2019,0.6923554785450463,0.30764452145495363
2510,Mojin: The Worm Valley,22381583,101516,22280067,2018.csv,2018,0.004535693476194244,0.9954643065238058
2511,The Contender,22361811,17872723,4489088,2000.csv,2000,0.7992520373238107,0.20074796267618933
2512,Harry Potter and the Chamber of Secrets 2021 Re-release,22349685,191501,22158184,2022.csv,2022,0.008568398167580439,0.9914316018324195
2513,Gretel & Hansel,22304357,15347654,6956703,2020.csv,2020,0.6881011633735956,0.31189883662640444
2514,Quill: The Life of a Guide Dog,22298559,0,22298559,2004.csv,2004,0.0,1.0
2515,Chouchou,22288364,0,22288364,2003.csv,2003,0.0,1.0
2516,6/45,22263336,0,22263336,2022.csv,2022,0.0,1.0
2517,NASCAR: The IMAX Experience,22248831,21583831,665000,2004.csv,2004,0.970110789191576,0.029889210808424046
2518,Ghosts of the Abyss,22141539,17040871,5100668,2003.csv,2003,0.7696335381203628,0.2303664618796372
2519,The Glass Castle,22088533,17273059,4815474,2017.csv,2017,0.7819921313923383,0.21800786860766172
2520,Manual of Love,22079820,0,22079820,2005.csv,2005,0.0,1.0
2521,Stree,22075730,0,22075730,2018.csv,2018,0.0,1.0
2522,Doraemon the Movie: Nobita's Little Star Wars 2021,22044058,0,22044058,2022.csv,2022,0.0,1.0
2523,Little Black Book,22035509,20698668,1336841,2004.csv,2004,0.9393324202313639,0.06066757976863616
2524,School of Magical Animals,21984454,288414,21696040,2021.csv,2021,0.01311899763350957,0.9868810023664905
2525,Kaamelott: First Installment,21979122,188000,21791122,2021.csv,2021,0.008553571885173574,0.9914464281148264
2526,See How They Run,21966634,9586237,12380397,2022.csv,2022,0.4363999054201932,0.5636000945798069
2527,Love Don't Cost a Thing,21964072,21924226,39846,2003.csv,2003,0.9981858555189584,0.0018141444810415846
2528,The Challenge,21899392,0,21899392,2023.csv,2023,0.0,1.0
2529,Ponniyin Selvan: Part I,21888295,4282000,17606295,2022.csv,2022,0.19562967330255737,0.8043703266974427
2530,Do You Know Claudia?,21852972,0,21852972,2004.csv,2004,0.0,1.0
2531,Mr. 3000,21839377,21811187,28190,2004.csv,2004,0.9987092122637015,0.0012907877362985218
2532,The Barbarian Invasions 2003 Re-release,21815430,3435749,18379681,2003.csv,2003,0.1574916928064219,0.8425083071935782
2533,Phone,21784403,0,21784403,2002.csv,2002,0.0,1.0
2534,Devotion,21768133,20511938,1256195,2022.csv,2022,0.9422920192558544,0.057707980744145584
2535,Torrente 3: El protector,21762391,0,21762391,2005.csv,2005,0.0,1.0
2536,The Covenant,21755275,16938039,4817236,2023.csv,2023,0.7785715878103127,0.22142841218968734
2537,After We Fell,21753705,2170750,19582955,2021.csv,2021,0.09978759939973443,0.9002124006002655
2538,Moana 2020 Re-release,21736672,0,21736672,2020.csv,2020,0.0,1.0
2539,Silent Parade,21723595,0,21723595,2022.csv,2022,0.0,1.0
2540,White Oleander,21672284,16357770,5314514,2002.csv,2002,0.7547783150128523,0.24522168498714764
2541,Father Stu,21592379,20884796,707583,2022.csv,2022,0.9672299657207758,0.03277003427922417
2542,Man of the House,21577624,19699706,1877918,2005.csv,2005,0.91296919438396,0.08703080561604003
2543,Épouse-moi mon pote,21571464,0,21571464,2017.csv,2017,0.0,1.0
2544,Wicker Park,21568818,13001257,8567561,2004.csv,2004,0.6027802265288714,0.3972197734711286
2545,Unplanned,21515607,19005109,2510498,2019.csv,2019,0.8833173519111034,0.11668264808889658
2546,Win a Date with Tad Hamilton!,21513434,17071962,4441472,2004.csv,2004,0.7935489053026124,0.20645109469738768
2547,Winged Migration,21493351,924651,20568700,2001.csv,2001,0.04302032754222457,0.9569796724577754
2548,"Are You There God? It's Me, Margaret.",21462505,20372406,1090099,2023.csv,2023,0.9492091440398034,0.05079085596019663
2549,The Merchant of Venice,21417725,3765585,17652140,2004.csv,2004,0.17581629234664278,0.8241837076533572
2550,Emergency Declaration,21400327,412196,20988131,2022.csv,2022,0.01926120100875094,0.980738798991249
2551,Crazy Romance,21386368,0,21386368,2019.csv,2019,0.0,1.0
2552,Year One in the North,21360942,0,21360942,2005.csv,2005,0.0,1.0
2553,Shaft,21360215,21360215,0,2019.csv,2019,1.0,0.0
2554,Rurouni Kenshin: Final Chapter Part II - The Beginning,21318560,0,21318560,2021.csv,2021,0.0,1.0
2555,Hotel Mumbai,21314816,9651611,11663205,2019.csv,2019,0.4528123067072219,0.5471876932927782
2556,Integrity,21290004,0,21290004,2019.csv,2019,0.0,1.0
2557,New York Minute,21289826,14071441,7218385,2004.csv,2004,0.6609467357788645,0.33905326422113546
2558,Stigmatized Properties,21276720,0,21276720,2020.csv,2020,0.0,1.0
2559,Michael Jordan to the Max,21268532,18650521,2618011,2000.csv,2000,0.8769068311813905,0.12309316881860957
2560,"Miraculous: Ladybug & Cat Noir, the Movie",21249707,0,21249707,2023.csv,2023,0.0,1.0
2561,The Prison,21205329,207481,20997848,2017.csv,2017,0.009784380143312088,0.9902156198566879
2562,Mindhunters,21148829,4480744,16668085,2004.csv,2004,0.2118672386069224,0.7881327613930776
2563,The Jacket,21126225,6303762,14822463,2005.csv,2005,0.2983856320757731,0.7016143679242269
2564,Wish Dragon,21120000,0,21120000,2021.csv,2021,0.0,1.0
2565,The Amazing Maurice,21110363,4303645,16806718,2022.csv,2022,0.20386409272071732,0.7961359072792827
2566,Pokémon the Movie: Secrets of the Jungle,21097921,0,21097921,2020.csv,2020,0.0,1.0
2567,The Secret Mission,21083522,0,21083522,2019.csv,2019,0.0,1.0
2568,Amores Perros,20908467,5408467,15500000,2001.csv,2001,0.2586735316367288,0.7413264683632712
2569,The Devil's Rejects,20901859,17044981,3856878,2005.csv,2005,0.8154767956285611,0.18452320437143893
2570,Pokémon Heroes,20867919,746381,20121538,2002.csv,2002,0.035766910921975495,0.9642330890780245
2571,A Moment to Remember,20865847,0,20865847,2005.csv,2005,0.0,1.0
2572,G.O.R.A.,20839049,0,20839049,2004.csv,2004,0.0,1.0
2573,Best in Show,20789556,18715392,2074164,2000.csv,2000,0.900230481112728,0.09976951888727205
2574,Crayon Shin-chan: Shrouded in Mystery! The Flowers of Tenkasu Academy,20752104,0,20752104,2021.csv,2021,0.0,1.0
2575,The Photograph,20690779,20578185,112594,2020.csv,2020,0.9945582522533347,0.005441747746665314
2576,Super Size Me,20645757,11536423,9109334,2004.csv,2004,0.5587793656585225,0.4412206343414775
2577,Crayon Shin-chan: Mononoke Ninja Chinpuden,20617005,0,20617005,2022.csv,2022,0.0,1.0
2578,The 11 Commandments,20537839,0,20537839,2004.csv,2004,0.0,1.0
2579,Yarn,20474270,0,20474270,2020.csv,2020,0.0,1.0
2580,One Hundred Thousand Bad Jokes 2,20460352,0,20460352,2017.csv,2017,0.0,1.0
2581,Doraemon: Nobita and the Wind Wizard,20428491,0,20428491,2003.csv,2003,0.0,1.0
2582,Ladies in Lavender,20377075,6765081,13611994,2004.csv,2004,0.3319947048337409,0.6680052951662592
2583,Violet Evergarden: The Movie,20339624,0,20339624,2020.csv,2020,0.0,1.0
2584,Brahms: The Boy II,20311536,12611536,7700000,2020.csv,2020,0.6209050856616654,0.37909491433833464
2585,Three Thousand Years of Longing,20282422,8286741,11995681,2022.csv,2022,0.4085676257007176,0.5914323742992824
2586,Ong-Bak: The Thai Warrior,20235426,4563167,15672259,2003.csv,2003,0.22550387622182996,0.77449612377817
2587,Serving Sara,20146150,16930185,3215965,2002.csv,2002,0.8403682589477394,0.1596317410522606
2588,Melinda and Melinda,20129327,3826280,16303047,2004.csv,2004,0.19008484486341745,0.8099151551365825
2589,Turning Red,20122621,0,20122621,2022.csv,2022,0.0,1.0
2590,Mulholland Drive,20117339,7220243,12897096,2001.csv,2001,0.35890646372266233,0.6410935362773377
2591,This Is Tomas,20084169,0,20084169,2019.csv,2019,0.0,1.0
2592,I Heart Huckabees,20072172,12785432,7286740,2004.csv,2004,0.6369730191630483,0.3630269808369518
2593,Asterix & Obelix: Mission Cleopatra 2002 Re-release,20015611,3115188,16900423,2002.csv,2002,0.155637916824023,0.8443620831759769
2594,Himalaya 2001 Re-release,19960881,2487878,17473003,2001.csv,2001,0.12463768508013248,0.8753623149198675
2595,Crazy/Beautiful,19937988,16937988,3000000,2001.csv,2001,0.8495334634567941,0.15046653654320585
2596,Ballistic: Ecks vs. Sever,19924033,14307963,5616070,2002.csv,2002,0.7181258432968868,0.2818741567031133
2597,Get Over It,19900366,11576464,8323902,2001.csv,2001,0.5817211603042879,0.4182788396957121
2598,Lorelei,19806585,0,19806585,2005.csv,2005,0.0,1.0
2599,Ice 2,19788995,0,19788995,2020.csv,2020,0.0,1.0
2600,Summer Catch,19772447,19753553,18894,2001.csv,2001,0.9990444278343494,0.0009555721656505136
2601,The Perfect Man,19770475,16535005,3235470,2005.csv,2005,0.8363483932480125,0.1636516067519875
2602,Stillwater,19754272,14465535,5288737,2021.csv,2021,0.7322737583040266,0.2677262416959734
2603,Thomas and the Magic Railroad,19748009,15933506,3814503,2000.csv,2000,0.8068411352253283,0.1931588647746717
2604,Shackleton's Antarctic Adventure,19613216,15553324,4059892,2001.csv,2001,0.7930022287013002,0.2069977712986998
2605,S1m0ne,19576023,9688676,9887347,2002.csv,2002,0.49492565471546496,0.5050743452845351
2606,Soul Snatcher,19561221,0,19561221,2020.csv,2020,0.0,1.0
2607,View from the Top,19526014,15614000,3912014,2003.csv,2003,0.7996511730453537,0.20034882695464626
2608,The Wolf and the Lion,19510578,2072173,17438405,2021.csv,2021,0.10620766847604413,0.8937923315239559
2609,The House of No Man,19490980,0,19490980,2023.csv,2023,0.0,1.0
2610,The Lion King 2002 IMAX Release,19486215,15686215,3800000,2002.csv,2002,0.8049903483051993,0.19500965169480067
2611,2046,19470239,1444588,18025651,2004.csv,2004,0.0741946721866126,0.9258053278133874
2612,Vanity Fair,19463185,16136476,3326709,2004.csv,2004,0.8290768443088836,0.17092315569111632
2613,My Happy Marriage,19439523,0,19439523,2023.csv,2023,0.0,1.0
2614,The Turning,19428166,15472775,3955391,2020.csv,2020,0.7964094500736714,0.2035905499263286
2615,Get Carter,19412993,14967182,4445811,2000.csv,2000,0.7709878636436948,0.2290121363563053
2616,The Specials,19363826,0,19363826,2019.csv,2019,0.0,1.0
2617,Tuck Everlasting,19344615,19161999,182616,2002.csv,2002,0.9905598534786038,0.009440146521396265
2618,Rock Star,19334145,17008282,2325863,2001.csv,2001,0.8797017918299465,0.12029820817005354
2619,Duplex,19322135,9692135,9630000,2003.csv,2003,0.5016078709728505,0.4983921290271494
2620,Deep Blue,19288261,132261,19156000,2003.csv,2003,0.006857072288683775,0.9931429277113162
2621,Mapado,19286223,0,19286223,2005.csv,2005,0.0,1.0
2622,O,19260537,16025437,3235100,2001.csv,2001,0.8320347973683184,0.16796520263168155
2623,Les Tuche 4,19259766,0,19259766,2021.csv,2021,0.0,1.0
2624,Fate/stay night [Heaven's Feel] III. spring song,19252497,200000,19052497,2020.csv,2020,0.010388262883510644,0.9896117371164893
2625,After Ever Happy,19238073,1072750,18165323,2022.csv,2022,0.055761821883096085,0.9442381781169039
2626,Half Past Dead,19233280,15567860,3665420,2002.csv,2002,0.809423041727672,0.19057695827232796
2627,Windstruck,19225992,0,19225992,2004.csv,2004,0.0,1.0
2628,Martin Lawrence Live: Runteldat,19184820,19184820,0,2002.csv,2002,1.0,0.0
2629,Simone: Woman of the Century,19149079,0,19149079,2022.csv,2022,0.0,1.0
2630,Dear Evan Hansen,19133454,15002646,4130808,2021.csv,2021,0.7841054730630445,0.21589452693695554
2631,The Weather Man,19126398,12482775,6643623,2005.csv,2005,0.6526464104741521,0.347353589525848
2632,Those Who Wish Me Dead,19107200,7407200,11700000,2021.csv,2021,0.3876653826829677,0.6123346173170323
2633,Always Miss You,19015465,91884,18923581,2019.csv,2019,0.0048320669518205316,0.9951679330481795
2634,The Corsican File,18922216,0,18922216,2004.csv,2004,0.0,1.0
2635,The Man Who Wasn't There,18916623,7504257,11412366,2001.csv,2001,0.3967017263070687,0.6032982736929313
2636,The Curse of the Jade Scorpion,18914307,7517191,11397116,2001.csv,2001,0.3974341222229289,0.602565877777071
2637,Beast,18911959,0,18911959,2022.csv,2022,0.0,1.0
2638,Feardotcom,18902015,13258249,5643766,2002.csv,2002,0.7014198750768106,0.2985801249231894
2639,The Pioneer,18900000,0,18900000,2021.csv,2021,0.0,1.0
2640,An Officer and a Spy,18899214,0,18899214,2019.csv,2019,0.0,1.0
2641,Champions,18894015,16271910,2622105,2023.csv,2023,0.8612203388215792,0.13877966117842078
2642,The Green Knight,18887953,17173321,1714632,2021.csv,2021,0.909220866866833,0.09077913313316695
2643,Antlers,18867659,10619670,8247989,2021.csv,2021,0.5628504309941154,0.43714956900588464
2644,Promising Young Woman,18854166,6460965,12393201,2020.csv,2020,0.34268102869148387,0.6573189713085161
2645,Sinkhole,18804231,0,18804231,2021.csv,2021,0.0,1.0
2646,Broker,18789304,1046899,17742405,2022.csv,2022,0.0557178169026378,0.9442821830973622
2647,Swing Girls,18758613,0,18758613,2004.csv,2004,0.0,1.0
2648,A Mighty Wind,18750246,17781006,969240,2003.csv,2003,0.948307878200638,0.051692121799361994
2649,Crayon Shin-chan: Honeymoon Hurricane - The Lost Hiroshi,18738951,0,18738951,2019.csv,2019,0.0,1.0
2650,Godfather,18737287,0,18737287,2022.csv,2022,0.0,1.0
2651,Mobile Suit Gundam: Hathaway,18731309,0,18731309,2021.csv,2021,0.0,1.0
2652,Look at Me,18729751,1737308,16992443,2004.csv,2004,0.09275659884640218,0.9072434011535978
2653,Iznogoud- Caliph Instead of the Caliph,18725588,0,18725588,2005.csv,2005,0.0,1.0
2654,Detective Conan: Strategy Above the Depths,18723952,0,18723952,2005.csv,2005,0.0,1.0
2655,3000 Miles to Graceland,18720175,15749959,2970216,2001.csv,2001,0.8413360986208729,0.15866390137912706
2656,The Ninth Gate,18661336,18661336,0,2000.csv,2000,1.0,0.0
2657,Greta,18653107,10532219,8120888,2019.csv,2019,0.56463617562479,0.43536382437521
2658,Waiting...,18637690,16124543,2513147,2005.csv,2005,0.8651578065736687,0.13484219342633127
2659,Max Keeble's Big Move,18634654,17294293,1340361,2001.csv,2001,0.9280715917773413,0.07192840822265871
2660,"Godzilla, Mothra and King Ghidorah: Giant Monsters All-Out Attack",18623382,0,18623382,2001.csv,2001,0.0,1.0
2661,An Unfinished Life,18618284,8586392,10031892,2005.csv,2005,0.46118063297347917,0.5388193670265208
2662,My Father and My Son,18612999,0,18612999,2005.csv,2005,0.0,1.0
2663,De-Lovely,18611951,13456633,5155318,2004.csv,2004,0.7230103388946167,0.2769896611053833
2664,Empire,18591272,17600423,990849,2002.csv,2002,0.9467035391661205,0.05329646083387947
2665,Keeping Mum,18575768,1619466,16956302,2005.csv,2005,0.0871816443874622,0.9128183556125378
2666,The Turkish Gambit,18520000,0,18520000,2005.csv,2005,0.0,1.0
2667,My Baby's Daddy,18490423,17669317,821106,2004.csv,2004,0.955592903418164,0.044407096581835906
2668,Loser,18404706,15618626,2786080,2000.csv,2000,0.848621325437092,0.151378674562908
2669,School of Magical Animals: Part 2,18385774,0,18385774,2022.csv,2022,0.0,1.0
2670,As It Is in Heaven,18318233,0,18318233,2005.csv,2005,0.0,1.0
2671,Bhool Bhulaiyaa 2,18307258,0,18307258,2022.csv,2022,0.0,1.0
2672,The World's Fastest Indian,18297690,5128124,13169566,2005.csv,2005,0.28026073236567023,0.7197392676343298
2673,Quai des illusions,18291248,0,18291248,2004.csv,2004,0.0,1.0
2674,Antitrust,18195610,11328094,6867516,2001.csv,2001,0.6225729173135718,0.3774270826864282
2675,My Boss's Daughter,18191005,15550605,2640400,2003.csv,2003,0.8548513399891869,0.14514866001081303
2676,All the Pretty Horses,18133495,15540353,2593142,2000.csv,2000,0.8569971205219954,0.14300287947800466
2677,November,18114769,0,18114769,2022.csv,2022,0.0,1.0
2678,Takizawa Enbujo Zero,18091395,0,18091395,2020.csv,2020,0.0,1.0
2679,Freaky,18073433,9030855,9042578,2020.csv,2020,0.4996756841934789,0.5003243158065211
2680,The Stronghold,18066143,0,18066143,2021.csv,2021,0.0,1.0
2681,The Country Bears,18012097,16990825,1021272,2002.csv,2002,0.9433007716980427,0.05669922830195729
2682,Quills,17989227,7065332,10923895,2000.csv,2000,0.3927535074186345,0.6072464925813655
2683,Fragments of the Last Will,17954691,0,17954691,2022.csv,2022,0.0,1.0
2684,Night Watch 2005 Re-release,17939389,1502188,16437201,2005.csv,2005,0.08373685413700545,0.9162631458629945
2685,My Tutor Friend,17896209,0,17896209,2003.csv,2003,0.0,1.0
2686,The New World,17823920,0,17823920,2003.csv,2003,0.0,1.0
2687,Jail Breakers,17797711,0,17797711,2002.csv,2002,0.0,1.0
2688,The Last Kiss,17720347,1048950,16671397,2002.csv,2002,0.05919466475458974,0.9408053352454102
2689,The Promised Neverland,17710977,0,17710977,2020.csv,2020,0.0,1.0
2690,Joyeux Noel,17709155,1054361,16654794,2005.csv,2005,0.059537623336630124,0.9404623766633698
2691,The Blackening,17707207,17707207,0,2023.csv,2023,1.0,0.0
2692,You Are My Sunshine,17650142,0,17650142,2005.csv,2005,0.0,1.0
2693,Kaiji: Final Game,17645779,0,17645779,2020.csv,2020,0.0,1.0
2694,About My Father,17612455,12089391,5523064,2023.csv,2023,0.686411462797208,0.313588537202792
2695,Palais royal!,17612135,0,17612135,2005.csv,2005,0.0,1.0
2696,Hitman: Agent Jun,17601351,0,17601351,2020.csv,2020,0.0,1.0
2697,Deliver Us from Eva,17573594,17573594,0,2003.csv,2003,1.0,0.0
2698,The Quintessential Quintuplets Movie,17506171,502000,17004171,2022.csv,2022,0.028675602448987845,0.9713243975510122
2699,Roll Bounce,17500866,17380866,120000,2005.csv,2005,0.9931431964566781,0.006856803543321799
2700,Rebound,17492014,16809014,683000,2005.csv,2005,0.9609536100302687,0.03904638996973133
2701,"Bố Già (Dad, I'm Sorry)",17480489,350000,17130489,2021.csv,2021,0.020022323174140037,0.97997767682586
2702,A Guy Thing,17432163,15545431,1886732,2003.csv,2003,0.8917671891893163,0.10823281081068367
2703,Frailty,17423030,13110448,4312582,2002.csv,2002,0.7524780706914929,0.2475219293085072
2704,Stormy Night,17379776,0,17379776,2005.csv,2005,0.0,1.0
2705,Fall,17363261,7240521,10122740,2022.csv,2022,0.4170023706952283,0.5829976293047717
2706,Digimon Adventure: Last Evolution Kizuna,17361009,0,17361009,2020.csv,2020,0.0,1.0
2707,The Matador,17347231,12594698,4752533,2005.csv,2005,0.7260350657692862,0.27396493423071383
2708,Would I Lie to You? 2,17317084,0,17317084,2003.csv,2003,0.0,1.0
2709,The Importance of Being Earnest,17290970,8384929,8906041,2002.csv,2002,0.4849310940913089,0.515068905908691
2710,Gintama: The Final,17252960,0,17252960,2021.csv,2021,0.0,1.0
2711,Railway Heroes,17223704,0,17223704,2021.csv,2021,0.0,1.0
2712,Tokyo Revengers 2: Bloody Halloween - Destiny,17216567,0,17216567,2023.csv,2023,0.0,1.0
2713,Kinsey,17050017,10254979,6795038,2004.csv,2004,0.6014644442876509,0.39853555571234917
2714,Kung Pow: Enter the Fist,16994625,16037962,956663,2002.csv,2002,0.9437079076472709,0.056292092352729174
2715,Dead Weight,16987957,0,16987957,2002.csv,2002,0.0,1.0
2716,Bye Bye Morons,16955924,0,16955924,2020.csv,2020,0.0,1.0
2717,Jason X,16951798,13121555,3830243,2001.csv,2001,0.7740509295828089,0.22594907041719114
2718,Catch That Kid,16951702,16703799,247903,2004.csv,2004,0.9853759227244556,0.014624077275544368
2719,Sugar & Spice,16908947,13305101,3603846,2001.csv,2001,0.7868675086627216,0.21313249133727843
2720,Life or Something Like It,16872671,14448589,2424082,2002.csv,2002,0.8563308678276249,0.1436691321723751
2721,Aegis,16869261,0,16869261,2005.csv,2005,0.0,1.0
2722,The Good Girl,16856124,14018296,2837828,2002.csv,2002,0.8316440956414417,0.16835590435855835
2723,Femme Fatale,16838910,6630252,10208658,2002.csv,2002,0.3937459134825235,0.6062540865174765
2724,House of 1000 Corpses,16829545,12634962,4194583,2003.csv,2003,0.7507607603176437,0.24923923968235623
2725,Paparazzi,16796512,15714234,1082278,2004.csv,2004,0.9355653126077604,0.06443468739223954
2726,House of Sand and Fog,16763804,13040288,3723516,2003.csv,2003,0.7778835877584825,0.22211641224151749
2727,Baaghi 3,16726510,721439,16005071,2020.csv,2020,0.043131472136147944,0.956868527863852
2728,Wunderschön,16719291,0,16719291,2022.csv,2022,0.0,1.0
2729,Father There Is Only One 3,16707892,0,16707892,2022.csv,2022,0.0,1.0
2730,Dogville,16680836,1535286,15145550,2003.csv,2003,0.0920389121984054,0.9079610878015946
2731,CyberWorld,16653900,11253900,5400000,2000.csv,2000,0.6757516257453209,0.32424837425467906
2732,Digimon: The Movie,16643191,9631153,7012038,2000.csv,2000,0.5786842799556888,0.4213157200443112
2733,The Dish,16575074,2552992,14022082,2000.csv,2000,0.1540259790092038,0.8459740209907962
2734,Your Turn to Kill,16511822,0,16511822,2021.csv,2021,0.0,1.0
2735,Cry Macho,16510734,10310734,6200000,2021.csv,2021,0.6244867127045957,0.3755132872954043
2736,Even If This Love Disappears from the World Tonight,16474515,0,16474515,2022.csv,2022,0.0,1.0
2737,They,16446271,12840842,3605429,2002.csv,2002,0.7807752894257914,0.2192247105742086
2738,The Powerpuff Girls Movie,16426471,11412414,5014057,2002.csv,2002,0.6947575045181646,0.3052424954818354
2739,Reminiscence,16400193,3900193,12500000,2021.csv,2021,0.2378138476784999,0.7621861523215001
2740,The Magdalene Sisters,16373112,306989,16066123,2002.csv,2002,0.018749581631152343,0.9812504183688476
2741,One Missed Call,16367880,0,16367880,2004.csv,2004,0.0,1.0
2742,"Nin x Nin: Ninja Hattori-kun, the Movie",16351134,0,16351134,2004.csv,2004,0.0,1.0
2743,Italian for Beginners,16349568,4544753,11804815,2000.csv,2000,0.27797388897370257,0.7220261110262974
2744,The Emperor's Club,16318449,14118751,2199698,2002.csv,2002,0.865201772545908,0.13479822745409198
2745,Rabbit-Proof Fence,16217411,6199600,10017811,2002.csv,2002,0.38228050087649623,0.6177194991235038
2746,Caché (Hidden),16197824,3647381,12550443,2005.csv,2005,0.22517722133540902,0.774822778664591
2747,Just Visiting,16176732,4781539,11395193,2001.csv,2001,0.2955812706793931,0.7044187293206069
2748,Birthday Girl,16171098,5142576,11028522,2002.csv,2002,0.31801031692467635,0.6819896830753236
2749,Iris,16153953,5594617,10559336,2001.csv,2001,0.3463311426002044,0.6536688573997956
2750,Legend No. 17,16096860,0,16096860,2021.csv,2021,0.0,1.0
2751,The Legend & Butterfly,16087771,0,16087771,2023.csv,2023,0.0,1.0
2752,I Still Believe,16069730,9868521,6201209,2020.csv,2020,0.6141062108697533,0.38589378913024674
2753,The Dry,16066821,364237,15702584,2021.csv,2021,0.02267013493210636,0.9773298650678937
2754,To Be and to Have,16063920,777129,15286791,2002.csv,2002,0.04837729520565341,0.9516227047943466
2755,Dr. Coto's Clinic,16062841,0,16062841,2022.csv,2022,0.0,1.0
2756,Doraemon: Nobita and the Robot Kingdom,16053687,0,16053687,2002.csv,2002,0.0,1.0
2757,What the #$*! Do We (K)now!?,15998178,10942306,5055872,2004.csv,2004,0.6839720123129022,0.3160279876870979
2758,Upon the Magic Roads,15990882,0,15990882,2021.csv,2021,0.0,1.0
2759,Radhe Shyam,15954804,1860000,14094804,2022.csv,2022,0.11657930739857413,0.8834206926014259
2760,Drowning Mona,15906764,15506764,400000,2000.csv,2000,0.974853464853065,0.025146535146934976
2761,Blacklight,15902207,9591094,6311113,2022.csv,2022,0.603129741676737,0.39687025832326295
2762,Public Enemy,15897574,0,15897574,2002.csv,2002,0.0,1.0
2763,Before Sunset,15849759,5820649,10029110,2004.csv,2004,0.3672389592800749,0.6327610407199251
2764,Highlander: Endgame,15843608,12811858,3031750,2000.csv,2000,0.8086452277789251,0.1913547722210749
2765,Lucky Luke and the Daltons,15823762,0,15823762,2004.csv,2004,0.0,1.0
2766,Die drei ??? - Erbe des Drachen,15821876,0,15821876,2023.csv,2023,0.0,1.0
2767,Shin Kamen Rider,15787771,0,15787771,2023.csv,2023,0.0,1.0
2768,The Great Yokai War,15787492,0,15787492,2005.csv,2005,0.0,1.0
2769,Kiss Kiss Bang Bang,15785148,4243756,11541392,2005.csv,2005,0.26884486607284264,0.7311551339271574
2770,The Gospel,15778152,15778152,0,2005.csv,2005,1.0,0.0
2771,Lantana,15747450,4623189,11124261,2001.csv,2001,0.2935833420649058,0.7064166579350942
2772,Operation Mincemeat,15710164,0,15710164,2022.csv,2022,0.0,1.0
2773,Enigma 2001 Re-release,15705007,4301582,11403425,2001.csv,2001,0.27389876362360105,0.7261012363763989
2774,Maison de retraite,15570823,0,15570823,2022.csv,2022,0.0,1.0
2775,Facing Windows,15530077,543354,14986723,2003.csv,2003,0.03498720579427906,0.965012794205721
2776,Two Sons of Francisco,15508288,0,15508288,2005.csv,2005,0.0,1.0
2777,IDOLiSH7 Movie: LIVE 4bit - BEYOND THE PERiOD,15500146,0,15500146,2023.csv,2023,0.0,1.0
2778,The Way Back,15490514,13590514,1900000,2020.csv,2020,0.8773442895439105,0.12265571045608945
2779,With a Friend Like Harry...,15472186,3830441,11641745,2001.csv,2001,0.24756947725421605,0.7524305227457839
2780,Bait,15471969,15325127,146842,2000.csv,2000,0.9905091588536663,0.009490841146333735
2781,Zelary,15461305,330033,15131272,2003.csv,2003,0.02134574022050532,0.9786542597794947
2782,The Night House,15437703,7100581,8337122,2021.csv,2021,0.45995061571012213,0.5400493842898778
2783,The Greatest Game Ever Played,15431177,15337393,93784,2005.csv,2005,0.9939224337845389,0.006077566215461076
2784,Padre no hay más que uno 2: La llegada de la suegra,15373181,0,15373181,2020.csv,2020,0.0,1.0
2785,Harry Potter and the Sorcerer's Stone 2021 Re-release,15372357,799342,14573015,2021.csv,2021,0.0519986622741067,0.9480013377258933
2786,Alex & Emma,15368897,14218698,1150199,2003.csv,2003,0.9251606019612207,0.07483939803877923
2787,Drive My Car,15360756,2352240,13008516,2021.csv,2021,0.15313308798082595,0.8468669120191741
2788,Minari,15312445,3110580,12201865,2021.csv,2021,0.20314064801538878,0.7968593519846112
2789,Brother,15250594,450594,14800000,2001.csv,2001,0.029545996700194106,0.9704540032998059
2790,Hey Arnold! The Movie,15249308,13728902,1520406,2002.csv,2002,0.9002967216610748,0.09970327833892528
2791,Bheemla Nayak,15243922,0,15243922,2022.csv,2022,0.0,1.0
2792,Something About Love,15204017,0,15204017,2021.csv,2021,0.0,1.0
2793,Transamerica,15151744,9015303,6136441,2005.csv,2005,0.5950010111047283,0.40499898889527175
2794,Bones and All,15134907,7834907,7300000,2022.csv,2022,0.517671301184738,0.48232869881526197
2795,Surviving Christmas,15125687,11663156,3462531,2004.csv,2004,0.7710827283415292,0.22891727165847078
2796,The Dreamers,15121165,2532228,12588937,2003.csv,2003,0.1674624937959476,0.8325375062040524
2797,Terrifier 2,15065239,10640105,4425134,2022.csv,2022,0.7062685829278912,0.29373141707210887
2798,Firestarter,15039250,9739250,5300000,2022.csv,2022,0.6475888092823778,0.3524111907176222
2799,Boat Trip,15020293,8600126,6420167,2002.csv,2002,0.5725671263536604,0.42743287364633964
2800,Anita,15017470,556632,14460838,2021.csv,2021,0.03706563089521737,0.9629343691047826
2801,Oldboy,14980005,707481,14272524,2003.csv,2003,0.0472283553977452,0.9527716446022548
2802,Undisputed,14946150,12764657,2181493,2002.csv,2002,0.8540431482354988,0.14595685176450124
2803,"Murder, Take One",14915208,0,14915208,2005.csv,2005,0.0,1.0
2804,A Guilty Conscience,14914575,0,14914575,2023.csv,2023,0.0,1.0
2805,The Last Trapper,14905929,0,14905929,2004.csv,2004,0.0,1.0
2806,Battle Royale II,14899584,0,14899584,2003.csv,2003,0.0,1.0
2807,The Wolf of Wall Street 2022 Re-release,14877539,0,14877539,2022.csv,2022,0.0,1.0
2808,Raise Your Voice,14867514,10411980,4455534,2004.csv,2004,0.7003174841469798,0.2996825158530202
2809,Josie and the Pussycats,14866015,14271015,595000,2001.csv,2001,0.9599758240523771,0.040024175947622816
2810,Supernova,14828081,14230455,597626,2000.csv,2000,0.9596963356215817,0.040303664378418216
2811,Soul Plane,14821824,14190750,631074,2004.csv,2004,0.9574226491962123,0.04257735080378771
2812,One Piece: Dead End Adventure,14817006,0,14817006,2003.csv,2003,0.0,1.0
2813,Possession,14815898,10113733,4702165,2002.csv,2002,0.6826270672219801,0.3173729327780199
2814,Out Cold,14782676,13906394,876282,2001.csv,2001,0.940722369887563,0.059277630112437016
2815,Bros,14781867,11628165,3153702,2022.csv,2022,0.7866506308032672,0.21334936919673272
2816,The Triplets of Belleville,14776760,7007149,7769611,2003.csv,2003,0.47420063667542817,0.5257993633245718
2817,Superwho?,14770359,0,14770359,2022.csv,2022,0.0,1.0
2818,Most Beautiful Week in My Life,14765033,0,14765033,2005.csv,2005,0.0,1.0
2819,X,14740889,11765309,2975580,2022.csv,2022,0.7981410754805901,0.20185892451940993
2820,Iron Monkey,14694904,14694904,0,2001.csv,2001,1.0,0.0
2821,Together with You,14687167,1151941,13535226,2003.csv,2003,0.07843180376447002,0.92156819623553
2822,The Chosen Season 3: Episode 1 & 2,14679613,14612089,67524,2022.csv,2022,0.9954001512165205,0.00459984878347951
2823,Samurai Commando Mission 1549,14648713,0,14648713,2005.csv,2005,0.0,1.0
2824,Half a Confession,14638660,0,14638660,2004.csv,2004,0.0,1.0
2825,Welcome to Mooseport,14615099,14470947,144152,2004.csv,2004,0.9901367756728846,0.009863224327115403
2826,Together,14572229,1034829,13537400,2001.csv,2001,0.07101377558642538,0.9289862244135746
2827,Hollywood Ending,14569744,4850753,9718991,2002.csv,2002,0.33293330342660793,0.6670666965733921
2828,Envy,14494036,13562325,931711,2004.csv,2004,0.9357176289613189,0.06428237103868101
2829,Malena,14493284,3448233,11045051,2000.csv,2000,0.23791937010273173,0.7620806298972683
2830,I Dreamed of Africa,14400327,6651522,7748805,2000.csv,2000,0.4619007610035522,0.5380992389964477
2831,The Tomorrow War,14400000,0,14400000,2021.csv,2021,0.0,1.0
2832,The Personal History of David Copperfield,14399270,1876298,12522972,2020.csv,2020,0.130305077965758,0.869694922034242
2833,How to Deal,14390329,14195227,195102,2003.csv,2003,0.986442144581962,0.013557855418038044
2834,And So the Baton Is Passed,14368469,0,14368469,2021.csv,2021,0.0,1.0
2835,Joy Ride,14352925,12897789,1455136,2023.csv,2023,0.8986174595073826,0.10138254049261736
2836,Being Julia,14339171,7739049,6600122,2004.csv,2004,0.5397138370133113,0.4602861629866887
2837,Freddy Got Fingered,14333252,14254993,78259,2001.csv,2001,0.9945400387853364,0.005459961214663637
2838,Nightlife,14308789,0,14308789,2020.csv,2020,0.0,1.0
2839,Stealing Harvard,14277032,14036406,240626,2002.csv,2002,0.9831459367745341,0.01685406322546591
2840,Blood Rain,14270938,0,14270938,2005.csv,2005,0.0,1.0
2841,The Duke,14227217,1526970,12700247,2022.csv,2022,0.10732738525039717,0.8926726147496028
2842,Sarkaru Vaari Paata,14199018,0,14199018,2022.csv,2022,0.0,1.0
2843,Pawn,14193957,0,14193957,2020.csv,2020,0.0,1.0
2844,Proof,14189860,7535331,6654529,2005.csv,2005,0.5310363174830478,0.46896368251695225
2845,What Planet Are You From?,14145677,6291602,7854075,2000.csv,2000,0.4447720671128006,0.5552279328871994
2846,Godzilla Against MechaGodzilla,14122958,0,14122958,2002.csv,2002,0.0,1.0
2847,Football Days,14117202,0,14117202,2003.csv,2003,0.0,1.0
2848,Sword Art Online: Progressive - Aria of a Starless Night,14032747,1050000,12982747,2021.csv,2021,0.07482497902940885,0.9251750209705911
2849,Osmosis Jones,14026418,13596911,429507,2001.csv,2001,0.9693787109438775,0.030621289056122526
2850,Ghosts of Mars,14010832,8709640,5301192,2001.csv,2001,0.621636174068749,0.3783638259312509
2851,The Post 2020 Re-release,13995207,0,13995207,2020.csv,2020,0.0,1.0
2852,Vizontele Tuuba,13954476,0,13954476,2004.csv,2004,0.0,1.0
2853,Wet Dreams,13936317,0,13936317,2002.csv,2002,0.0,1.0
2854,She Said,13934825,5825995,8108830,2022.csv,2022,0.4180888529278265,0.5819111470721735
2855,Bodies Bodies Bodies,13929670,11446602,2483068,2022.csv,2022,0.8217425107701761,0.17825748922982382
2856,Tokyo Revengers 2: Bloody Halloween - Decisive Battle,13915338,0,13915338,2023.csv,2023,0.0,1.0
2857,Monster,13910991,0,13910991,2022.csv,2022,0.0,1.0
2858,Dirty Pretty Things,13904766,8112414,5792352,2002.csv,2002,0.5834268624153761,0.4165731375846239
2859,Memory,13897255,7329043,6568212,2022.csv,2022,0.5273734273423061,0.4726265726576939
2860,Touching the Void,13885802,4593598,9292204,2003.csv,2003,0.33081258108102074,0.6691874189189793
2861,French Spies,13844465,0,13844465,2004.csv,2004,0.0,1.0
2862,The Legend of Maula Jatt,13839539,5016493,8823046,2022.csv,2022,0.362475440836577,0.637524559163423
2863,House of the Dead,13818181,10249719,3568462,2003.csv,2003,0.7417560241829225,0.25824397581707753
2864,Juwanna Mann,13802599,13670733,131866,2002.csv,2002,0.9904462920352899,0.009553707964710124
2865,The Ladies Man,13743212,13616610,126602,2000.csv,2000,0.9907880341218632,0.009211965878136785
2866,Christmas with the Chosen: The Messengers,13728000,13728000,0,2021.csv,2021,1.0,0.0
2867,Mavka: The Forest Song,13703565,0,13703565,2023.csv,2023,0.0,1.0
2868,American Outlaws,13678913,13342790,336123,2001.csv,2001,0.9754276527674385,0.024572347232561534
2869,Eiffel,13649605,444814,13204791,2021.csv,2021,0.03258804925124207,0.967411950748758
2870,Der Wixxer,13607165,0,13607165,2004.csv,2004,0.0,1.0
2871,Anything Else,13585075,3212310,10372765,2003.csv,2003,0.23645876080919687,0.7635412391908032
2872,One Night at McCool's,13473370,6290673,7182697,2001.csv,2001,0.46689677489744585,0.5331032251025541
2873,OSS 117: From Africa with Love,13457801,0,13457801,2021.csv,2021,0.0,1.0
2874,The Point Men,13433834,0,13433834,2023.csv,2023,0.0,1.0
2875,#Alive,13432212,0,13432212,2020.csv,2020,0.0,1.0
2876,One Piece: The Cursed Holy Sword,13422333,0,13422333,2004.csv,2004,0.0,1.0
2877,Trapped,13414416,7073251,6341165,2002.csv,2002,0.5272872855590582,0.47271271444094176
2878,Solarmax,13400161,13400161,0,2000.csv,2000,1.0,0.0
2879,Howling Village,13394556,0,13394556,2020.csv,2020,0.0,1.0
2880,Umizaru,13361623,0,13361623,2004.csv,2004,0.0,1.0
2881,RRRrrrr!!!,13315054,54361,13260693,2004.csv,2004,0.004082672139369469,0.9959173278606306
2882,Glass Onion,13280000,13280000,0,2022.csv,2022,1.0,0.0
2883,Valimai,13276393,0,13276393,2022.csv,2022,0.0,1.0
2884,Vera Drake,13267869,3775283,9492586,2004.csv,2004,0.2845432827230959,0.7154567172769041
2885,Vidocq,13240767,0,13240767,2001.csv,2001,0.0,1.0
2886,Kal Ho Naa Ho,13200241,1991922,11208319,2003.csv,2003,0.15090042674220872,0.8490995732577913
2887,Come Play,13182254,10475990,2706264,2020.csv,2020,0.7947040013035707,0.2052959986964293
2888,Hostage: Missing Celebrity,13174292,0,13174292,2021.csv,2021,0.0,1.0
2889,Head Over Heels,13127022,10424470,2702552,2001.csv,2001,0.7941229930139524,0.20587700698604755
2890,Toei Spring Anime Fair,13107237,0,13107237,2002.csv,2002,0.0,1.0
2891,The Crew,13105853,13023075,82778,2000.csv,2000,0.9936838907013531,0.006316109298646948
2892,Long Time Dead,13102295,0,13102295,2002.csv,2002,0.0,1.0
2893,Moonage Daydream,13095697,4218925,8876772,2022.csv,2022,0.3221611648467432,0.6778388351532568
2894,Easter Sunday,13074255,13013690,60565,2022.csv,2022,0.9953676136804736,0.004632386319526428
2895,The Way of the Gun,13069740,6055661,7014079,2000.csv,2000,0.4633344657200526,0.5366655342799475
2896,The Barbarian Invasions,13065317,5109226,7956091,2003.csv,2003,0.39105258601838744,0.6089474139816126
2897,Vakeel Saab,13056490,0,13056490,2021.csv,2021,0.0,1.0
2898,The Many Saints of Newark,13037403,8237403,4800000,2021.csv,2021,0.6318285167682551,0.36817148323174487
2899,Onmyoji 2,13022862,0,13022862,2003.csv,2003,0.0,1.0
2900,Monkey King Reborn,13012133,0,13012133,2021.csv,2021,0.0,1.0
2901,Sisu,13008980,7265622,5743358,2023.csv,2023,0.5585081997205008,0.44149180027949925
2902,"Manta, Manta - Zwoter Teil",13000848,0,13000848,2023.csv,2023,0.0,1.0
2903,The Divorce,12991996,9081057,3910939,2003.csv,2003,0.6989731985754922,0.30102680142450783
2904,Mariages!,12991310,0,12991310,2004.csv,2004,0.0,1.0
2905,Gods and Generals,12923936,12882934,41002,2003.csv,2003,0.9968274370903725,0.0031725629096275316
2906,No Escapes,12916151,0,12916151,2021.csv,2021,0.0,1.0
2907,Formula 51,12881605,5204007,7677598,2001.csv,2001,0.4039874689528207,0.5960125310471793
2908,The Bodin's in the Land of Smile,12872253,0,12872253,2021.csv,2021,0.0,1.0
2909,In the Mood for Love,12854953,2738980,10115973,2000.csv,2000,0.21306806800460493,0.7869319319953951
2910,Smugglers,12825438,0,12825438,2023.csv,2023,0.0,1.0
2911,The Girl from Paris,12812396,183266,12629130,2001.csv,2001,0.014303803909901006,0.985696196090099
2912,Knockaround Guys,12806614,11715637,1090977,2002.csv,2002,0.9148114404010302,0.08518855959896972
2913,Samjin Company English Class,12761386,0,12761386,2020.csv,2020,0.0,1.0
2914,Another Round,12742455,0,12742455,2020.csv,2020,0.0,1.0
2915,Love Again,12696584,6230837,6465747,2023.csv,2023,0.4907490865259506,0.5092509134740494
2916,The Worst Person in the World,12687293,3034775,9652518,2021.csv,2021,0.2391979912499853,0.7608020087500147
2917,"Remember Me, My Love",12671306,227986,12443320,2003.csv,2003,0.01799230481846149,0.9820076951815385
2918,News of the World,12668325,12668325,0,2020.csv,2020,1.0,0.0
2919,Chasing Papi,12661189,6130049,6531140,2003.csv,2003,0.4841606108241493,0.5158393891758507
2920,Collectors,12640113,0,12640113,2020.csv,2020,0.0,1.0
2921,Winged Migration 2003 Re-release,12634963,10764402,1870561,2003.csv,2003,0.8519535830852849,0.14804641691471515
2922,Narc,12633747,10465659,2168088,2002.csv,2002,0.8283891548564333,0.17161084514356667
2923,The Other Side of the Bed,12630208,0,12630208,2002.csv,2002,0.0,1.0
2924,Character,12628017,0,12628017,2021.csv,2021,0.0,1.0
2925,Epic Tails,12613012,0,12613012,2023.csv,2023,0.0,1.0
2926,Maria Full of Grace,12594630,6529624,6065006,2004.csv,2004,0.5184450833410748,0.48155491665892525
2927,Gossip,12591270,5108820,7482450,2000.csv,2000,0.4057430267161295,0.5942569732838705
2928,Breakin' All the Rules,12544254,12264319,279935,2004.csv,2004,0.9776842050551591,0.022315794944840883
2929,Apocalypse Now Redux,12543269,4626290,7916979,2001.csv,2001,0.36882649969477654,0.6311735003052235
2930,On the Line,12522284,0,12522284,2021.csv,2021,0.0,1.0
2931,The Clearing,12520799,5763875,6756924,2004.csv,2004,0.46034402437096866,0.5396559756290313
2932,Sorority Boys,12517488,10200032,2317456,2002.csv,2002,0.8148625347194262,0.18513746528057387
2933,Seducing Doctor Lewis,12504038,9354342,3149696,2003.csv,2003,0.7481056919372766,0.2518943080627234
2934,Ready to Rumble,12452362,12394327,58035,2000.csv,2000,0.9953394384133709,0.004660561586629107
2935,Nine Queens,12413888,1222889,11190999,2002.csv,2002,0.09850974972546876,0.9014902502745312
2936,Monsieur Ibrahim,12364836,2823890,9540946,2003.csv,2003,0.22838070800130306,0.7716192919986969
2937,Casshern,12353768,0,12353768,2004.csv,2004,0.0,1.0
2938,Say It Isn't So,12320393,5520393,6800000,2001.csv,2001,0.4480695542747703,0.5519304457252298
2939,Chasing Liberty,12313323,12195626,117697,2004.csv,2004,0.990441491707803,0.009558508292196996
2940,Guglhupfgeschwader,12307072,0,12307072,2022.csv,2022,0.0,1.0
2941,Abandon,12302219,10727683,1574536,2002.csv,2002,0.8720120329511286,0.12798796704887141
2942,"Utapri Movie 2, Uta No Prince-Sama Maji Love Starish Tours Movie",12291650,0,12291650,2022.csv,2022,0.0,1.0
2943,His Only Son,12234765,12084084,150681,2023.csv,2023,0.987684193362112,0.012315806637888019
2944,Shinchan: Crash! Scribble Kingdom and Almost Four Heroes,12221804,0,12221804,2020.csv,2020,0.0,1.0
2945,Living,12208598,3038113,9170485,2022.csv,2022,0.24885027748476934,0.7511497225152307
2946,Koi... Mil Gaya,12168232,671372,11496860,2003.csv,2003,0.05517416170237385,0.9448258382976261
2947,The Eye,12165016,512049,11652967,2002.csv,2002,0.04209192984209803,0.957908070157902
2948,Ducobu 3,12157793,0,12157793,2020.csv,2020,0.0,1.0
2949,Dark Blue,12150301,9250301,2900000,2003.csv,2003,0.7613227853367583,0.23867721466324168
2950,On Your Mark,12100000,0,12100000,2021.csv,2021,0.0,1.0
2951,Laal Singh Chaddha,12093536,3401324,8692212,2022.csv,2022,0.2812514057096287,0.7187485942903713
2952,Don't Move,12071007,337265,11733742,2004.csv,2004,0.027940088179884248,0.9720599118201158
2953,Alienoid,12067556,168309,11899247,2022.csv,2022,0.013947231734412502,0.9860527682655875
2954,Kureyon Shin-chan 2004 Re-release,12066375,0,12066375,2004.csv,2004,0.0,1.0
2955,2009: Lost Memories,12049825,0,12049825,2002.csv,2002,0.0,1.0
2956,The Cookout,12009070,11814019,195051,2004.csv,2004,0.9837580262251782,0.016241973774821863
2957,Stand by Me,11900000,0,11900000,2021.csv,2021,0.0,1.0
2958,The Asadas,11858018,0,11858018,2020.csv,2020,0.0,1.0
2959,Layer Cake,11850214,2339957,9510257,2004.csv,2004,0.1974611597731484,0.8025388402268516
2960,The Rules of Attraction,11819244,6532619,5286625,2002.csv,2002,0.5527103933212649,0.44728960667873513
2961,The Son's Room,11767402,1016340,10751062,2001.csv,2001,0.08636910679179652,0.9136308932082035
2962,Beyond Borders,11705002,4430101,7274901,2003.csv,2003,0.3784793031218619,0.621520696878138
2963,Mohou-han,11702775,0,11702775,2002.csv,2002,0.0,1.0
2964,Wotakoi: Love Is Hard for Otaku,11702371,0,11702371,2020.csv,2020,0.0,1.0
2965,Les rois mages,11702020,0,11702020,2001.csv,2001,0.0,1.0
2966,That Time I Got Reincarnated as a Slime the Movie: Scarlet Bond,11631738,1588491,10043247,2022.csv,2022,0.1365652321261019,0.8634347678738982
2967,The Order,11560806,7660806,3900000,2002.csv,2002,0.6626532786727846,0.33734672132721544
2968,The Legend of Drunken Master,11555430,11555430,0,2000.csv,2000,1.0,0.0
2969,Face Off 6: The Ticket of Destiny,11538081,0,11538081,2023.csv,2023,0.0,1.0
2970,Jug Jugg Jeeyo,11467726,1033000,10434726,2022.csv,2022,0.09007888747952297,0.909921112520477
2971,The Experiment,11455141,0,11455141,2001.csv,2001,0.0,1.0
2972,Beau Is Afraid,11454102,8176562,3277540,2023.csv,2023,0.7138544776360469,0.28614552236395313
2973,Suspect Zero,11416075,8725813,2690262,2004.csv,2004,0.7643444003302361,0.2356555996697639
2974,Empire of Light,11395604,1177577,10218027,2022.csv,2022,0.10333607591137775,0.8966639240886223
2975,Till,11347030,9000202,2346828,2022.csv,2022,0.7931768929843316,0.20682310701566842
2976,Connie and Carla,11341016,8085771,3255245,2004.csv,2004,0.7129670745548723,0.28703292544512765
2977,Kabhi Khushi Kabhie Gham...,11329690,2902000,8427690,2001.csv,2001,0.2561411653805179,0.7438588346194821
2978,The Fable: The Killer Who Doesn't Kill,11325545,0,11325545,2021.csv,2021,0.0,1.0
2979,Bergen,11325405,0,11325405,2022.csv,2022,0.0,1.0
2980,What Did You Eat Yesterday?,11320893,0,11320893,2021.csv,2021,0.0,1.0
2981,The Dope,11289473,0,11289473,2003.csv,2003,0.0,1.0
2982,The Little Polar Bear,11243547,0,11243547,2001.csv,2001,0.0,1.0
2983,You Can Count on Me,11242521,9416804,1825717,2000.csv,2000,0.8376060849697323,0.16239391503026768
2984,Rise,11196824,0,11196824,2022.csv,2022,0.0,1.0
2985,Shadow of the Vampire,11155214,8293784,2861430,2000.csv,2000,0.7434894570377583,0.2565105429622417
2986,The Eight Mountains,11152455,302456,10849999,2022.csv,2022,0.027120127362092024,0.972879872637908
2987,Men,11152071,7587853,3564218,2022.csv,2022,0.680398555568737,0.31960144443126304
2988,Aline,11149943,667815,10482128,2021.csv,2021,0.059894028157812106,0.9401059718421879
2989,Naruto the Movie: Ninja Clash in the Land of Snow,11141307,0,11141307,2004.csv,2004,0.0,1.0
2990,What's Love Got to Do with It?,11111510,0,11111510,2023.csv,2023,0.0,1.0
2991,Kamen Rider 555: Paradise Lost,11067556,0,11067556,2003.csv,2003,0.0,1.0
2992,Head-On,11030861,435395,10595466,2004.csv,2004,0.039470626998200774,0.9605293730017992
2993,Adrenaline Rush: The Science of Risk,11011932,10994028,17904,2002.csv,2002,0.9983741272648614,0.0016258727351385752
2994,30 jours max,11007713,0,11007713,2020.csv,2020,0.0,1.0
2995,Bigfoot Family,10987975,0,10987975,2020.csv,2020,0.0,1.0
2996,The Voice of Sin,10983063,0,10983063,2020.csv,2020,0.0,1.0
2997,District B13,10976892,1200216,9776676,2004.csv,2004,0.10934023947762263,0.8906597605223774
2998,Extreme Ops,10959475,4842259,6117216,2002.csv,2002,0.441833117006061,0.558166882993939
2999,The Perfect Score,10898337,10391003,507334,2004.csv,2004,0.9534484940225284,0.04655150597747161
3000,Lucky Numbers,10890222,10042516,847706,2000.csv,2000,0.9221589789445982,0.0778410210554018
3001,Chickenhare and the Hamster of Darkness,10885116,0,10885116,2022.csv,2022,0.0,1.0
3002,Samurai Beyond Admiration Record to the World's Best,10876188,0,10876188,2023.csv,2023,0.0,1.0
3003,Two by Two: Overboard!,10875424,0,10875424,2020.csv,2020,0.0,1.0
3004,Here on Earth,10873148,10522168,350980,2000.csv,2000,0.9677204798463149,0.03227952015368502
3005,Let Him Go,10835686,9358025,1477661,2020.csv,2020,0.8636301384148636,0.13636986158513636
3006,One Second,10791301,0,10791301,2020.csv,2020,0.0,1.0
3007,Me contro Te - Il film: La vendetta del Signor S,10779891,0,10779891,2020.csv,2020,0.0,1.0
3008,Godzilla: Tokyo S.O.S.,10724345,0,10724345,2003.csv,2003,0.0,1.0
3009,Impractical Jokers: The Movie,10691091,10691091,0,2020.csv,2020,1.0,0.0
3010,The Machine,10664328,10458331,205997,2023.csv,2023,0.9806835461174862,0.01931645388251374
3011,Honest Candidate,10597464,0,10597464,2020.csv,2020,0.0,1.0
3012,Champion,10569737,0,10569737,2002.csv,2002,0.0,1.0
3013,Pollock,10558970,8598593,1960377,2000.csv,2000,0.814340129766445,0.18565987023355499
3014,The Hunt,10550350,5812500,4737850,2020.csv,2020,0.5509295900136014,0.4490704099863986
3015,Inuyasha the Movie: Affections Touching Across Time,10539779,0,10539779,2001.csv,2001,0.0,1.0
3016,Anatomy,10501958,9660,10492298,2000.csv,2000,0.0009198284738902974,0.9990801715261097
3017,Warriors of Future,10490328,0,10490328,2022.csv,2022,0.0,1.0
3018,The Cooler,10464788,8291572,2173216,2003.csv,2003,0.7923306234201782,0.2076693765798218
3019,Krack,10442916,0,10442916,2021.csv,2021,0.0,1.0
3020,The Virgin Suicides,10409377,4906229,5503148,2000.csv,2000,0.4713278229811448,0.5286721770188552
3021,A Touch of Spice,10395779,0,10395779,2003.csv,2003,0.0,1.0
3022,Jurassic Park 2022 Re-release,10374018,0,10374018,2022.csv,2022,0.0,1.0
3023,Town & Country,10372291,6719973,3652318,2001.csv,2001,0.6478774072189066,0.35212259278109337
3024,Wasabi,10366360,97220,10269140,2001.csv,2001,0.009378412480369195,0.9906215875196308
3025,Kaiserschmarrndrama,10357720,0,10357720,2021.csv,2021,0.0,1.0
3026,Land of Legends,10357479,0,10357479,2022.csv,2022,0.0,1.0
3027,"Caution, Hazardous Wife: The Movie",10356359,0,10356359,2021.csv,2021,0.0,1.0
3028,The Last Warrior,10348542,0,10348542,2021.csv,2021,0.0,1.0
3029,Street Dancer 3D,10339127,0,10339127,2020.csv,2020,0.0,1.0
3030,Bibi Blocksberg,10325928,0,10325928,2002.csv,2002,0.0,1.0
3031,Detective Conan: The Scarlet Alibi,10308627,0,10308627,2021.csv,2021,0.0,1.0
3032,The Pirates: The Last Royal Treasure,10258331,0,10258331,2022.csv,2022,0.0,1.0
3033,The Beasts,10238603,5000,10233603,2022.csv,2022,0.0004883478732401285,0.9995116521267599
3034,The Wash,10229331,10097538,131793,2001.csv,2001,0.9871161662478221,0.012883833752177928
3035,Never Stop,10224935,0,10224935,2021.csv,2021,0.0,1.0
3036,Ainbo,10202069,0,10202069,2021.csv,2021,0.0,1.0
3037,My Spy,10200000,0,10200000,2020.csv,2020,0.0,1.0
3038,Woman on Top,10194274,5020111,5174163,2000.csv,2000,0.492444189748088,0.507555810251912
3039,Vaillante,10143170,0,10143170,2022.csv,2022,0.0,1.0
3040,Table for Six,10138355,0,10138355,2022.csv,2022,0.0,1.0
3041,Thirteen,10128960,4601043,5527917,2003.csv,2003,0.4542463392095536,0.5457536607904464
3042,Sun and Concrete,10119958,0,10119958,2023.csv,2023,0.0,1.0
3043,Kamen Rider Ryuki: Episode Final,10112538,0,10112538,2002.csv,2002,0.0,1.0
3044,Pulse: A Stomp Odyssey,10086514,10086514,0,2002.csv,2002,1.0,0.0
3045,Sexy Beast,10045677,6946056,3099621,2001.csv,2001,0.6914472762761534,0.30855272372384657
3046,Girls on Top,10038662,0,10038662,2001.csv,2001,0.0,1.0
3047,Godzilla 2000: Millennium,10037390,10037390,0,2000.csv,2000,1.0,0.0
3048,The Deep End,10031529,8823109,1208420,2001.csv,2001,0.8795378052538152,0.12046219474618475
3049,Kisarazu Cat's Eye: Nihon Series,10029866,0,10029866,2003.csv,2003,0.0,1.0
3050,The Crime Is Mine,10025717,0,10025717,2023.csv,2023,0.0,1.0
3051,Elephant,10012022,1266955,8745067,2003.csv,2003,0.12654336956111362,0.8734566304388863
3052,Smack Dab Kakha,9995945,0,9995945,2022.csv,2022,0.0,1.0
3053,Whatever It Takes,9902115,8745680,1156435,2000.csv,2000,0.8832133337170898,0.11678666628291026
3054,Shin Chan: The Adult Empire Strikes Back,9851449,0,9851449,2003.csv,2003,0.0,1.0
3055,F3: Fun and Frustration,9849193,1195000,8654193,2022.csv,2022,0.12132973737036121,0.8786702626296388
3056,3 Strikes,9832166,9832166,0,2000.csv,2000,1.0,0.0
3057,"Good Luck to You, Leo Grande",9783843,0,9783843,2022.csv,2022,0.0,1.0
3058,100% Wolf,9766489,658764,9107725,2020.csv,2020,0.06745146592598425,0.9325485340740157
3059,Pearl,9747742,9423445,324297,2022.csv,2022,0.9667310644865241,0.03326893551347584
3060,Black Box,9738741,0,9738741,2021.csv,2021,0.0,1.0
3061,Eiga Sumikkogurashi: Aoi tsukiyo no mahô no ko,9735732,0,9735732,2021.csv,2021,0.0,1.0
3062,My Life Without Me,9726954,400948,9326006,2003.csv,2003,0.041220303910144945,0.958779696089855
3063,Bread and Tulips,9719848,5318679,4401169,2000.csv,2000,0.547197754532787,0.4528022454672131
3064,Rheingold,9691011,0,9691011,2022.csv,2022,0.0,1.0
3065,Stolen Identity 2,9687188,0,9687188,2020.csv,2020,0.0,1.0
3066,The Young Black Stallion,9638389,6751389,2887000,2003.csv,2003,0.7004686156576582,0.29953138434234183
3067,Spider-Man: No Way Home 2022 Re-release,9613518,9321593,291925,2022.csv,2022,0.9696339050907274,0.030366094909272546
3068,The Soul,9600000,0,9600000,2021.csv,2021,0.0,1.0
3069,Married for 7 Years,9545175,0,9545175,2003.csv,2003,0.0,1.0
3070,¡A todo tren! Destino Asturias,9544171,0,9544171,2021.csv,2021,0.0,1.0
3071,Talk to Her Undated France Release,9541068,0,9541068,2022.csv,2022,0.0,1.0
3072,Baragaki: Unbroken Samurai,9481437,0,9481437,2021.csv,2021,0.0,1.0
3073,10 Days with Dad,9472077,2359,9469718,2020.csv,2020,0.000249047806515931,0.9997509521934841
3074,Secret Zoo,9471940,0,9471940,2020.csv,2020,0.0,1.0
3075,Redeeming Love,9464198,9214020,250178,2022.csv,2022,0.9735658531235293,0.026434146876470672
3076,365 Days,9458590,0,9458590,2020.csv,2020,0.0,1.0
3077,Veronica Guerin,9439660,1571504,7868156,2003.csv,2003,0.1664788774171951,0.8335211225828049
3078,Okay Madam,9433525,0,9433525,2020.csv,2020,0.0,1.0
3079,Hypnotic,9424597,4500169,4924428,2023.csv,2023,0.4774919288326068,0.5225080711673932
3080,Ghost Dog: The Way of the Samurai,9380473,3308029,6072444,2000.csv,2000,0.3526505539752633,0.6473494460247367
3081,The Flying Classroom,9378807,0,9378807,2003.csv,2003,0.0,1.0
3082,L'appel de la forêt,9317347,0,9317347,2020.csv,2020,0.0,1.0
3083,Mad Love,9306362,280046,9026316,2001.csv,2001,0.030091887678557958,0.969908112321442
3084,House Party,9284647,9002247,282400,2023.csv,2023,0.9695841963620156,0.0304158036379843
3085,Dad,9267397,0,9267397,2021.csv,2021,0.0,1.0
3086,Women Talking,9259397,5456531,3802866,2022.csv,2022,0.5892965816240517,0.41070341837594826
3087,State and Main,9206279,6944471,2261808,2000.csv,2000,0.7543189816428548,0.24568101835714515
3088,Past Lives,9199489,9141172,58317,2023.csv,2023,0.9936608435533756,0.006339156446624372
3089,Inception 10th Anniversary re-release,9100000,0,9100000,2020.csv,2020,0.0,1.0
3090,Sword Art Online the Movie: Progressive - Scherzo of Deep Night,9071701,0,9071701,2022.csv,2022,0.0,1.0
3091,The Closet,9039424,0,9039424,2020.csv,2020,0.0,1.0
3092,All Your Faces,8969128,0,8969128,2023.csv,2023,0.0,1.0
3093,Malasaña 32,8968845,0,8968845,2020.csv,2020,0.0,1.0
3094,Break the Silence: The Movie,8954345,0,8954345,2020.csv,2020,0.0,1.0
3095,"Spring, Summer, Fall, Winter... and Spring",8944914,2380788,6564126,2003.csv,2003,0.26616108327033666,0.7338389167296634
3096,I Hate Summer,8926071,0,8926071,2020.csv,2020,0.0,1.0
3097,Kandahar,8914751,1418314,7496437,2001.csv,2001,0.15909743300738294,0.8409025669926171
3098,All About My Mother,8900000,0,8900000,2021.csv,2021,0.0,1.0
3099,Downhill,8899195,8287061,612134,2020.csv,2020,0.9312146772826081,0.06878532271739185
3100,Les blagues de Toto,8859185,0,8859185,2020.csv,2020,0.0,1.0
3101,Après Vous,8852763,830292,8022471,2003.csv,2003,0.09378902383357603,0.906210976166424
3102,The Wandering Earth II,8850805,5023132,3827673,2023.csv,2023,0.5675339135818719,0.43246608641812806
3103,The Eleventh Chapter,8844997,0,8844997,2021.csv,2021,0.0,1.0
3104,The Medium,8826689,0,8826689,2021.csv,2021,0.0,1.0
3105,The Vault,8803864,0,8803864,2021.csv,2021,0.0,1.0
3106,Kaguya-sama: Love Is War,8794981,0,8794981,2021.csv,2021,0.0,1.0
3107,Moonbound,8790990,0,8790990,2021.csv,2021,0.0,1.0
3108,18 Years Later,8785730,25611,8760119,2003.csv,2003,0.0029150679567890203,0.997084932043211
3109,Son of the Bride,8772695,624757,8147938,2001.csv,2001,0.07121608582083384,0.9287839141791662
3110,Ghost World,8764007,6217849,2546158,2001.csv,2001,0.7094755857680168,0.29052441423198316
3111,Le coeur des hommes,8755325,0,8755325,2003.csv,2003,0.0,1.0
3112,The Protégé,8737253,7446823,1290430,2021.csv,2021,0.8523071267365154,0.14769287326348454
3113,The Secret Garden,8721243,0,8721243,2020.csv,2020,0.0,1.0
3114,The Forsaken,8704851,7288451,1416400,2001.csv,2001,0.8372861293088187,0.16271387069118126
3115,Tini: The New Life of Violetta,8678476,0,8678476,2001.csv,2001,0.0,1.0
3116,Lost Illusions,8635184,126391,8508793,2021.csv,2021,0.014636746593934767,0.9853632534060652
3117,War of the Eltis,8613864,0,8613864,2020.csv,2020,0.0,1.0
3118,Father & Soldier,8588159,0,8588159,2023.csv,2023,0.0,1.0
3119,The Prince and the Pirate,8579972,0,8579972,2001.csv,2001,0.0,1.0
3120,Agent Backkom: Kings Bear,8578734,0,8578734,2021.csv,2021,0.0,1.0
3121,Samrat Prithviraj,8568339,0,8568339,2022.csv,2022,0.0,1.0
3122,Pil's Adventures,8567345,0,8567345,2021.csv,2021,0.0,1.0
3123,Before Night Falls,8527517,4242892,4284625,2000.csv,2000,0.49755303917893096,0.502446960821069
3124,Life Is Beautiful,8458639,0,8458639,2022.csv,2022,0.0,1.0
3125,Honey Lemon Soda,8441488,0,8441488,2021.csv,2021,0.0,1.0
3126,Malang,8399765,0,8399765,2020.csv,2020,0.0,1.0
3127,Yolki 9,8385030,0,8385030,2022.csv,2022,0.0,1.0
3128,Bones,8378853,7316658,1062195,2001.csv,2001,0.8732290684655764,0.12677093153442362
3129,The Lord of the Rings: The Fellowship of the Ring 2021 Re-release,8377569,0,8377569,2021.csv,2021,0.0,1.0
3130,Delicious,8357060,0,8357060,2021.csv,2021,0.0,1.0
3131,Dream,8317251,0,8317251,2023.csv,2023,0.0,1.0
3132,Don,8287406,0,8287406,2022.csv,2022,0.0,1.0
3133,Shotgun Wedding,8277788,0,8277788,2022.csv,2022,0.0,1.0
3134,Aftersun,8256289,1658790,6597499,2022.csv,2022,0.20091229849148934,0.7990877015085107
3135,Kandahar,8245332,4813132,3432200,2023.csv,2023,0.583740230229662,0.4162597697703379
3136,Vikram Vedha,8234166,1589362,6644804,2022.csv,2022,0.19302039817997355,0.8069796018200265
3137,Merry Christmas,8228560,0,8228560,2001.csv,2001,0.0,1.0
3138,I Don't Have Any Money Left in My Retirement Account,8204616,0,8204616,2021.csv,2021,0.0,1.0
3139,Girls to Buy,8177284,0,8177284,2021.csv,2021,0.0,1.0
3140,White Snake 2: Green Snake,8170000,0,8170000,2021.csv,2021,0.0,1.0
3141,Re/Member,8166175,0,8166175,2022.csv,2022,0.0,1.0
3142,New Happy Dad and Son 4,8070000,0,8070000,2021.csv,2021,0.0,1.0
3143,Acharya,8048175,832000,7216175,2022.csv,2022,0.1033774737751105,0.8966225262248895
3144,Il grande giorno,8021940,0,8021940,2022.csv,2022,0.0,1.0
3145,Your Eyes Tell,8020474,0,8020474,2020.csv,2020,0.0,1.0
3146,The Tatta's,8000956,0,8000956,2022.csv,2022,0.0,1.0
3147,"My Donkey, My Lover & I",7973799,152184,7821615,2020.csv,2020,0.019085507422497105,0.9809144925775029
3148,Sur les chemins noirs,7964795,0,7964795,2023.csv,2023,0.0,1.0
3149,Rabbit Academy: Mission Eggpossible,7953802,0,7953802,2022.csv,2022,0.0,1.0
3150,AI Amok,7932191,0,7932191,2020.csv,2020,0.0,1.0
3151,Sunny Sisters,7880000,0,7880000,2021.csv,2021,0.0,1.0
3152,Ducobu 4 President,7858171,0,7858171,2022.csv,2022,0.0,1.0
3153,The Lost Prince,7837980,0,7837980,2020.csv,2020,0.0,1.0
3154,Antebellum,7792716,0,7792716,2020.csv,2020,0.0,1.0
3155,Contra,7762797,0,7762797,2021.csv,2021,0.0,1.0
3156,The Marriage Escape,7760946,0,7760946,2020.csv,2020,0.0,1.0
3157,Butterfly,7733894,2092682,5641212,2000.csv,2000,0.27058581356299943,0.7294141864370005
3158,Spirited Away Studio Ghibli Fest 2020,7732435,0,7732435,2020.csv,2020,0.0,1.0
3159,Jeanne du Barry,7678760,0,7678760,2023.csv,2023,0.0,1.0
3160,Princess Mononoke Studio Ghibli Fest 2020,7673207,0,7673207,2020.csv,2020,0.0,1.0
3161,Hard Hit,7658021,0,7658021,2021.csv,2021,0.0,1.0
3162,The Hole,7644361,0,7644361,2001.csv,2001,0.0,1.0
3163,Sex and Lucía,7640680,1594779,6045901,2001.csv,2001,0.2087221294439762,0.7912778705560238
3164,The Heist of the Century,7627100,0,7627100,2020.csv,2020,0.0,1.0
3165,Ants in the Pants,7625967,0,7625967,2000.csv,2000,0.0,1.0
3166,Monkeybone,7622365,5411999,2210366,2001.csv,2001,0.7100157234664044,0.28998427653359554
3167,Little Canned Men,7600000,0,7600000,2021.csv,2021,0.0,1.0
3168,Pushpa: The Rise - Part 1,7592374,1320000,6272374,2021.csv,2021,0.1738586639699256,0.8261413360300743
3169,Phases of the Moon,7564756,0,7564756,2022.csv,2022,0.0,1.0
3170,The Mauritanian,7527030,836536,6690494,2021.csv,2021,0.11113759344655195,0.8888624065534481
3171,777 Charlie,7523995,0,7523995,2022.csv,2022,0.0,1.0
3172,The Ice Road,7502846,0,7502846,2021.csv,2021,0.0,1.0
3173,De Gaulle,7501454,0,7501454,2020.csv,2020,0.0,1.0
3174,Fukushima 50,7494243,0,7494243,2020.csv,2020,0.0,1.0
3175,Judas and the Black Messiah,7478009,5478009,2000000,2021.csv,2021,0.7325491317274424,0.2674508682725576
3176,Love Letter 2021 Re-release,7400000,0,7400000,2021.csv,2021,0.0,1.0
3177,Requiem for a Dream,7390108,3635482,3754626,2000.csv,2000,0.49193895407211913,0.5080610459278809
3178,Signal: The Movie,7388603,0,7388603,2021.csv,2021,0.0,1.0
3179,Bachchhan Paandey,7387882,0,7387882,2022.csv,2022,0.0,1.0
3180,Eiga 'Ichikei no karasu',7377092,0,7377092,2023.csv,2023,0.0,1.0
3181,The Best Years,7355020,0,7355020,2020.csv,2020,0.0,1.0
3182,Lesson in Murder,7348964,0,7348964,2022.csv,2022,0.0,1.0
3183,Family Affairs,7330755,0,7330755,2022.csv,2022,0.0,1.0
3184,Listy do M. 5,7328061,0,7328061,2022.csv,2022,0.0,1.0
3185,Laid-Back Camp Movie,7317913,0,7317913,2022.csv,2022,0.0,1.0
3186,Mean Machine,7310206,92770,7217436,2001.csv,2001,0.012690476848395244,0.9873095231516048
3187,Osomatsusan the Movie 2022 Re-release,7297522,0,7297522,2022.csv,2022,0.0,1.0
3188,Star Wars: Episode VI - Return of the Jedi 2023 Re-release,7259924,7259924,0,2023.csv,2023,1.0,0.0
3189,Where the Money Is,7243669,5661798,1581871,2000.csv,2000,0.7816201982724501,0.21837980172754995
3190,Mamma Mia! Here We Go Again 2020 Re-release,7220137,0,7220137,2020.csv,2020,0.0,1.0
3191,Screwed,7201701,7027345,174356,2000.csv,2000,0.9757896085938585,0.02421039140614141
3192,Widow of St. Pierre,7193889,3193889,4000000,2000.csv,2000,0.44397251611749916,0.5560274838825008
3193,The (UN)perfect Guy,7154649,0,7154649,2020.csv,2020,0.0,1.0
3194,Bohemian Rhapsody 2020 Re-release,7154052,240000,6914052,2020.csv,2020,0.03354742179676636,0.9664525782032336
3195,Pravednik,7106593,0,7106593,2023.csv,2023,0.0,1.0
3196,Back to the Wharf,7090000,0,7090000,2020.csv,2020,0.0,1.0
3197,Adu,7085946,0,7085946,2020.csv,2020,0.0,1.0
3198,Croupier,7075068,6201143,873925,2000.csv,2000,0.8764782190079304,0.12352178099206962
3199,Les petites victoires,7056157,0,7056157,2023.csv,2023,0.0,1.0
3200,Fatale,7031289,6306897,724392,2020.csv,2020,0.896975931440167,0.10302406855983305
3201,Spycies,6989285,0,6989285,2020.csv,2020,0.0,1.0
3202,Dragon Rider,6977378,0,6977378,2020.csv,2020,0.0,1.0
3203,Knights of the Zodiac,6951086,1090155,5860931,2023.csv,2023,0.15683232807075037,0.8431676719292496
3204,Jim Button and the Wild 13,6933267,0,6933267,2020.csv,2020,0.0,1.0
3205,The Slurb,6854681,0,6854681,2001.csv,2001,0.0,1.0
3206,Beautiful Disaster,6850036,0,6850036,2023.csv,2023,0.0,1.0
3207,China: The Panda Adventure,6784985,3921642,2863343,2001.csv,2001,0.5779883080065763,0.4220116919934237
3208,The Road Home,6780490,1280490,5500000,2001.csv,2001,0.1888491834660917,0.8111508165339083
3209,The Piano Teacher,6749315,1012069,5737246,2001.csv,2001,0.14995136543486265,0.8500486345651374
3210,Psy 3: W imie zasad,6725146,0,6725146,2020.csv,2020,0.0,1.0
3211,Blood Moon Party,6709383,0,6709383,2020.csv,2020,0.0,1.0
3212,Innocence,6659968,0,6659968,2020.csv,2020,0.0,1.0
3213,Duets,6620242,4739023,1881219,2000.csv,2000,0.7158383334023137,0.2841616665976863
3214,Shubh Mangal Zyada Saavdhan,6574905,0,6574905,2020.csv,2020,0.0,1.0
3215,Chhapaak,6532100,604334,5927766,2020.csv,2020,0.09251756709174691,0.907482432908253
3216,Under the Sand,6531687,1452698,5078989,2001.csv,2001,0.22240777918476498,0.777592220815235
3217,"Love Me, Love Me Not",6494241,0,6494241,2020.csv,2020,0.0,1.0
3218,The Devil's Backbone,6459020,755249,5703771,2001.csv,2001,0.11692934841508464,0.8830706515849154
3219,Hammamet,6434874,0,6434874,2020.csv,2020,0.0,1.0
3220,Lindenberg! Mach dein Ding,6404964,0,6404964,2020.csv,2020,0.0,1.0
3221,Midnight Swan,6397065,0,6397065,2020.csv,2020,0.0,1.0
3222,Nausicaä of the Valley of the Wind 2020 Re-release,6395525,0,6395525,2020.csv,2020,0.0,1.0
3223,Rafadan Tayfa Galaktik Tayfa,6326137,0,6326137,2023.csv,2023,0.0,1.0
3224,Simply Black,6323750,0,6323750,2020.csv,2020,0.0,1.0
3225,Kishibe Rohan Rûvuru e iku,6292792,0,6292792,2023.csv,2023,0.0,1.0
3226,My Boyfriend's Meds,6292780,2971116,3321664,2020.csv,2020,0.47214680951820975,0.5278531904817902
3227,Poyekhavshaya,6281428,0,6281428,2023.csv,2023,0.0,1.0
3228,Marlowe,6276005,4350243,1925762,2023.csv,2023,0.6931548015019109,0.30684519849808917
3229,Bill & Ted Face the Music,6274027,3439660,2834367,2020.csv,2020,0.5482379977006793,0.4517620022993207
3230,Vacaciones de verano,6225389,0,6225389,2023.csv,2023,0.0,1.0
3231,Hotel Belgrade,6199413,0,6199413,2020.csv,2020,0.0,1.0
3232,Mafia Mamma,6120609,3496761,2623848,2023.csv,2023,0.5713093255916201,0.42869067440837993
3233,Life for Real,6100224,0,6100224,2023.csv,2023,0.0,1.0
3234,"And Yet, You Are So Sweet",6099393,0,6099393,2023.csv,2023,0.0,1.0
3235,A Brighter Tomorrow,6064691,0,6064691,2023.csv,2023,0.0,1.0
3236,Megiddo: The Omega Code 2,6047691,6047691,0,2001.csv,2001,1.0,0.0
3237,Chaos,6042938,0,6042938,2001.csv,2001,0.0,1.0
3238,How to Be a Good Wife,6033430,0,6033430,2020.csv,2020,0.0,1.0
3239,Big George Foreman,6031202,5426772,604430,2023.csv,2023,0.8997828293597196,0.10021717064028032
3240,The Legacy Of Dr. Death: Black File,6024046,0,6024046,2020.csv,2020,0.0,1.0
3241,A Piece of Cake,6008448,0,6008448,2020.csv,2020,0.0,1.0
3242,Now or Never,5995963,0,5995963,2000.csv,2000,0.0,1.0
3243,The Rhythm Section,5989583,5437971,551612,2020.csv,2020,0.9079047740051353,0.09209522599486475
3244,How I Became a Gangster,5975729,0,5975729,2020.csv,2020,0.0,1.0
3245,The Childe,5932589,102021,5830568,2023.csv,2023,0.01719670787914012,0.9828032921208599
3246,L'Innocente,5929392,22549,5906843,2020.csv,2020,0.003802919422429821,0.9961970805775702
3247,Twiceborn,5880157,11527,5868630,2020.csv,2020,0.001960321807734045,0.9980396781922659
3248,Tom Thumb,5867304,0,5867304,2001.csv,2001,0.0,1.0
3249,The Royal Bride,5830719,0,5830719,2020.csv,2020,0.0,1.0
3250,Beasts Clawing at Straws,5796059,0,5796059,2020.csv,2020,0.0,1.0
3251,The Lion King 2020 Re-release,5773266,0,5773266,2020.csv,2020,0.0,1.0
3252,The Golden Bowl,5753678,3050532,2703146,2001.csv,2001,0.5301881683333687,0.4698118316666313
3253,The Devil's Deal,5702702,0,5702702,2023.csv,2023,0.0,1.0
3254,You Hurt My Feelings,5689906,4830788,859118,2023.csv,2023,0.8490101593945488,0.15098984060545112
3255,Last Letter,5663972,0,5663972,2020.csv,2020,0.0,1.0
3256,Yowamushi Pedal: The Movie 2020 Re-release,5624218,0,5624218,2020.csv,2020,0.0,1.0
3257,Hocus Pocus 2020 Re-release,5609193,4828000,781193,2020.csv,2020,0.8607298768289842,0.13927012317101586
3258,Blue Giant,5604267,0,5604267,2023.csv,2023,0.0,1.0
3259,Infelices para Siempre,5602272,0,5602272,2023.csv,2023,0.0,1.0
3260,A Fish Tale,5595327,563911,5031416,2001.csv,2001,0.10078249224754872,0.8992175077524512
3261,The Chosen Season 3 Finale,5589142,5525069,64073,2023.csv,2023,0.9885361653005059,0.011463834699494127
3262,Klassikokkutulek 2: Pulmad ja matused,5543147,0,5543147,2020.csv,2020,0.0,1.0
3263,Black & White,5541431,5277299,264132,2000.csv,2000,0.9523350556922932,0.0476649443077068
3264,Made,5480653,5313300,167353,2001.csv,2001,0.9694647699827009,0.030535230017299034
3265,Mama Weed,5461144,29151,5431993,2020.csv,2020,0.0053378925734241765,0.9946621074265758
3266,Nefarious,5433685,5433685,0,2023.csv,2023,1.0,0.0
3267,Read My Lips,5393526,1471911,3921615,2001.csv,2001,0.2729032918354338,0.7270967081645662
3268,Detective Conan: Episode of Ai Haibara ~ Black Iron Mystery Train,5336285,0,5336285,2023.csv,2023,0.0,1.0
3269,Charlotte Gray,5323109,741394,4581715,2001.csv,2001,0.139278380360049,0.860721619639951
3270,Divorce Club,5316313,0,5316313,2020.csv,2020,0.0,1.0
3271,Cats & Dogs 3: Paws Unite,5300000,0,5300000,2020.csv,2020,0.0,1.0
3272,10 jours encore sans maman,5295494,0,5295494,2023.csv,2023,0.0,1.0
3273,The in Crowd,5280035,5280035,0,2000.csv,2000,1.0,0.0
3274,¡Vaya vacaciones!,5277413,0,5277413,2023.csv,2023,0.0,1.0
3275,Cindy la Regia,5222322,0,5222322,2020.csv,2020,0.0,1.0
3276,Little Bird: The Big Quest,5211523,0,5211523,2023.csv,2023,0.0,1.0
3277,Run,5184368,0,5184368,2020.csv,2020,0.0,1.0
3278,Infinity Pool,5183424,5078400,105024,2023.csv,2023,0.9797384894617921,0.02026151053820795
3279,Phantom,5173638,0,5173638,2023.csv,2023,0.0,1.0
3280,Hustler vs Scammer (Sieu Lua Gap Sieu Lay),5166455,0,5166455,2023.csv,2023,0.0,1.0
3281,The House of Mirth,5164404,3043284,2121120,2000.csv,2000,0.5892807766394729,0.4107192233605272
3282,The Unlikely Pilgrimage of Harold Fry,5145297,0,5145297,2023.csv,2023,0.0,1.0
3283,Rebound,5145202,0,5145202,2023.csv,2023,0.0,1.0
3284,Love Aaj Kal,5120794,0,5120794,2020.csv,2020,0.0,1.0
3285,Chi Chi Em Em 2,5109674,0,5109674,2023.csv,2023,0.0,1.0
3286,Masked Ward,5107013,0,5107013,2020.csv,2020,0.0,1.0
3287,Shylock's Children,5102646,0,5102646,2023.csv,2023,0.0,1.0
3288,Cats in the Museum,5101035,0,5101035,2023.csv,2023,0.0,1.0
3289,Emergency Landing,5092104,0,5092104,2023.csv,2023,0.0,1.0
3290,Ayyappanum Koshiyum,5088713,0,5088713,2020.csv,2020,0.0,1.0
3291,Baba Parasi,5084342,0,5084342,2020.csv,2020,0.0,1.0
3292,Die Känguru-Chroniken,5081127,0,5081127,2020.csv,2020,0.0,1.0
3293,Otto - Der Katastrofenfilm,5058355,0,5058355,2000.csv,2000,0.0,1.0
3294,The Real Exorcist,5035830,0,5035830,2020.csv,2020,0.0,1.0
3295,Allelujah,5035719,0,5035719,2023.csv,2023,0.0,1.0
3296,Ponniyin Selvan: Part Two,5035633,3813000,1222633,2023.csv,2023,0.7572037120258764,0.24279628797412361
3297,Me contro Te - il Film: Missione Giungla,5031684,0,5031684,2023.csv,2023,0.0,1.0
3298,Mayday,5011408,0,5011408,2020.csv,2020,0.0,1.0
3299,Someday or One Day,5009619,0,5009619,2023.csv,2023,0.0,1.0
3300,Bheeshma,4997080,0,4997080,2020.csv,2020,0.0,1.0
3301,Made in Abyss: Dawn of the Deep Soul,4971635,0,4971635,2020.csv,2020,0.0,1.0
3302,Just the Two of Us,4965555,0,4965555,2023.csv,2023,0.0,1.0
3303,Godai - The Wunderkind,4948225,0,4948225,2020.csv,2020,0.0,1.0
3304,Winnie the Pooh: Blood and Honey,4941200,1750639,3190561,2023.csv,2023,0.35429430097951914,0.6457056990204808
3305,Military Wives,4890505,0,4890505,2020.csv,2020,0.0,1.0
3306,Panga,4886124,582720,4303404,2020.csv,2020,0.11926017432222351,0.8807398256777765
3307,The Tales for Old and Young,4853143,0,4853143,2020.csv,2020,0.0,1.0
3308,Streltsov,4850073,0,4850073,2020.csv,2020,0.0,1.0
3309,Persian Lessons,4849240,0,4849240,2020.csv,2020,0.0,1.0
3310,The SpongeBob Movie: Sponge on the Run,4810790,4810790,0,2020.csv,2020,1.0,0.0
3311,Whipped,4775009,4159986,615023,2000.csv,2000,0.8711996144928732,0.1288003855071268
3312,Held Up,4705631,4705631,0,2000.csv,2000,1.0,0.0
3313,SSSS.Gridman,4636916,0,4636916,2023.csv,2023,0.0,1.0
3314,Sage homme,4613332,0,4613332,2023.csv,2023,0.0,1.0
3315,2018,4547765,0,4547765,2023.csv,2023,0.0,1.0
3316,IM HERO THE FINAL,4514656,0,4514656,2023.csv,2023,0.0,1.0
3317,Mari(dos),4483495,0,4483495,2023.csv,2023,0.0,1.0
3318,The Jungle Book 2000 Re-release,4466472,0,4466472,2000.csv,2000,0.0,1.0
3319,Maamannan,4463992,0,4463992,2023.csv,2023,0.0,1.0
3320,Maybe I Do,4442819,1293722,3149097,2023.csv,2023,0.2911939469062323,0.7088060530937678
3321,Last Night of Amore,4415564,0,4415564,2023.csv,2023,0.0,1.0
3322,The Tao of Steve,4406030,4342203,63827,2000.csv,2000,0.9855137164295296,0.014486283570470469
3323,Nyurnberg,4354380,0,4354380,2023.csv,2023,0.0,1.0
3324,When Will It Be Again Like It Never Was Before,4282908,0,4282908,2023.csv,2023,0.0,1.0
3325,Mohabbatein,4279351,1070000,3209351,2000.csv,2000,0.25003791462770875,0.7499620853722913
3326,The Book of Wonders,4249063,0,4249063,2023.csv,2023,0.0,1.0
3327,¡Que viva México!,4218942,161222,4057720,2023.csv,2023,0.0382138460305925,0.9617861539694075
3328,East Is East,4177818,4177818,0,2000.csv,2000,1.0,0.0
3329,Bossa Nova,4069261,1823297,2245964,2000.csv,2000,0.4480658773177734,0.5519341226822265
3330,Marry My Dead Body,4045026,0,4045026,2023.csv,2023,0.0,1.0
3331,Tu Jhoothi Main Makkaar,4035915,2503604,1532311,2023.csv,2023,0.6203312012269833,0.3796687987730168
3332,Erkan & Stefan,4026949,0,4026949,2000.csv,2000,0.0,1.0
3333,Touken Ranbu 2,4025574,0,4025574,2023.csv,2023,0.0,1.0
3334,Chevalier,3942191,3541159,401032,2023.csv,2023,0.8982717986013362,0.10172820139866384
3335,Pettson & Findus - Katten och gubbens år,3920489,0,3920489,2000.csv,2000,0.0,1.0
3336,Kutsal Damacana 4,3890946,0,3890946,2023.csv,2023,0.0,1.0
3337,Neposredstvenno Kakha. Drugoy film,3869893,0,3869893,2023.csv,2023,0.0,1.0
3338,Kokan Uso Nikki,3867992,0,3867992,2023.csv,2023,0.0,1.0
3339,Satyaprem Ki Katha,3846238,0,3846238,2023.csv,2023,0.0,1.0
3340,Unprincipled in the Village,3842262,0,3842262,2023.csv,2023,0.0,1.0
3341,Les vengeances de Maître Poutifard,3832815,0,3832815,2023.csv,2023,0.0,1.0
3342,The Sitting Duck,3832453,0,3832453,2023.csv,2023,0.0,1.0
3343,Nemesis the Movie: Mystery of Golden Spiral,3821231,0,3821231,2023.csv,2023,0.0,1.0
3344,Un homme heureux,3791739,0,3791739,2023.csv,2023,0.0,1.0
3345,Up at the Villa,3740113,2933161,806952,2000.csv,2000,0.7842439519875469,0.2157560480124531
3346,The Big Kahuna,3728888,3165544,563344,2000.csv,2000,0.8489243978365668,0.1510756021634332
3347,O chem govoryat muzhchiny. Prostyye udovolstviya,3686446,0,3686446,2023.csv,2023,0.0,1.0
3348,A Great Friend,3664736,0,3664736,2023.csv,2023,0.0,1.0
3349,Left Behind: Rise of the Antichrist,3649422,3649422,0,2023.csv,2023,1.0,0.0
3350,The Journey: A Music Special from Andrea Bocelli,3598985,3574915,24070,2023.csv,2023,0.9933120032453595,0.006687996754640544
3351,Price of Glory,3548556,3440228,108328,2000.csv,2000,0.9694726531017124,0.030527346898287643
3352,The Black Demon,3539540,0,3539540,2023.csv,2023,0.0,1.0
3353,A Thousand and One,3463680,3400020,63660,2023.csv,2023,0.9816207039911308,0.01837929600886918
3354,Carry on Jatta 3,3353522,0,3353522,2023.csv,2023,0.0,1.0
3355,Neposlushnaya,3339676,0,3339676,2023.csv,2023,0.0,1.0
3356,The Communion Girl,3331181,0,3331181,2023.csv,2023,0.0,1.0
3357,Gun Shy,3221280,1638202,1583078,2000.csv,2000,0.5085562260964586,0.49144377390354144
3358,Con Nhot Mot Chong,3217638,0,3217638,2023.csv,2023,0.0,1.0
3359,Tramite amicizia,3212885,0,3212885,2023.csv,2023,0.0,1.0
3360,Beautiful,3169930,3157348,12582,2000.csv,2000,0.996030827179149,0.003969172820850933
3361,My Beautiful Man ～Eternal～,3147751,0,3147751,2023.csv,2023,0.0,1.0
3362,Switch,3146901,0,3146901,2023.csv,2023,0.0,1.0
3363,Saigo made Iku,3135462,0,3135462,2023.csv,2023,0.0,1.0
3364,To Catch a Killer,3046603,0,3046603,2023.csv,2023,0.0,1.0
3365,2023 Oscar Nominated Short Films: Live Action,3025631,3025631,0,2023.csv,2023,1.0,0.0
3366,Isn't She Great,3003296,2962465,40831,2000.csv,2000,0.9864046034756481,0.013595396524351912
3367,Count,2988798,0,2988798,2023.csv,2023,0.0,1.0
3368,John Farnham: Finding the Voice,2979360,0,2979360,2023.csv,2023,0.0,1.0
3369,Grazie ragazzi,2927984,0,2927984,2023.csv,2023,0.0,1.0
3370,Asterix & Obelix: Mission Cleopatra 2023 Re-release,2927160,0,2927160,2023.csv,2023,0.0,1.0
3371,Two Tickets to Greece,2910645,0,2910645,2023.csv,2023,0.0,1.0
3372,Over My Dead Body,2893637,0,2893637,2023.csv,2023,0.0,1.0
3373,No More School,2870533,0,2870533,2000.csv,2000,0.0,1.0
3374,Flickering Lights,2760019,0,2760019,2000.csv,2000,0.0,1.0
3375,The Color of Paradise,2724595,1817216,907379,2000.csv,2000,0.6669673841433313,0.3330326158566686
3376,The Quintessential Quintuplets Specials,2687534,0,2687534,2023.csv,2023,0.0,1.0
3377,Yudo: The Way of the Bath,2681954,0,2681954,2023.csv,2023,0.0,1.0
3378,A Good Person,2665428,2210465,454963,2023.csv,2023,0.8293095893042318,0.17069041069576818
3379,Notre tout petit petit mariage,2658906,0,2658906,2023.csv,2023,0.0,1.0
3380,Rascal Does Not Dream of a Sister Venturing Out,2647589,0,2647589,2023.csv,2023,0.0,1.0
3381,God's Army,2637726,2637726,0,2000.csv,2000,1.0,0.0
3382,But I'm a Cheerleader,2595216,2205627,389589,2000.csv,2000,0.849881859544639,0.15011814045536095
3383,Ostrov,2587061,0,2587061,2023.csv,2023,0.0,1.0
3384,The First Day of My Life,2553978,0,2553978,2023.csv,2023,0.0,1.0
3385,Varisu,2528333,0,2528333,2023.csv,2023,0.0,1.0
3386,The Lulus,2521080,0,2521080,2023.csv,2023,0.0,1.0
3387,Come Out in Jesus Name,2500574,2500574,0,2023.csv,2023,1.0,0.0
3388,Polite Society,2498503,1545600,952903,2023.csv,2023,0.6186104239218444,0.3813895760781556
3389,Yaga i kniga zaklinaniy,2481493,0,2481493,2023.csv,2023,0.0,1.0
3390,Bamboozled,2463650,2274979,188671,2000.csv,2000,0.9234180991618127,0.07658190083818724
3391,East/West,2321029,2321029,0,2000.csv,2000,1.0,0.0
3392,Shower,2150929,1157764,993165,2000.csv,2000,0.5382623043345457,0.4617376956654543
3393,Left Luggage,2111280,1069540,1041740,2000.csv,2000,0.5065836838316092,0.4934163161683907
3394,Blood Simple 2000 Re-release,2068701,1701855,366846,2000.csv,2000,0.82266842815854,0.17733157184145992
3395,Marlene,2061924,0,2061924,2000.csv,2000,0.0,1.0
3396,Hamlet,2046433,1577287,469146,2000.csv,2000,0.7707493966330684,0.22925060336693162
3397,The Broken Hearts Club: A Romantic Comedy,2019121,1746585,272536,2000.csv,2000,0.8650224528396268,0.13497754716037325
3398,Cecil B. Demented,1961544,1284646,676898,2000.csv,2000,0.6549157194536549,0.3450842805463451
3399,The Life and Times of Hank Greenberg,1712385,1712385,0,2000.csv,2000,1.0,0.0
3400,The Girl on the Bridge,1708839,1708839,0,2000.csv,2000,1.0,0.0
